puckman	小精靈 (日本版 set 1, Probably Bootleg)	小精靈 (日本版 set 1, Probably Bootleg)	Namco
puckmana	小精靈 (日本版 set 2)	小精靈 (日本版 set 2)	Namco
puckmanf	小精靈 (日本版 set 1 with speedup hack)	小精靈 (日本版 set 1 with speedup hack)	Namco
puckmanh	小精靈 / Puckman (Falcom?)	小精靈 / Puckman (Falcom?)	hack
pacman	小精靈 (Midway)	小精靈 (Midway)	[Namco] (Midway license)
pacmanf	小精靈 (Midway, with speedup hack)	小精靈 (Midway, with speedup hack)	[Namco] (Midway license)
puckmod	小精靈 (日本版 set 3)	小精靈 (日本版 set 3)	Namco
pacmod	小精靈 (Midway, harder)	小精靈 (Midway, harder)	[Namco] (Midway license)
newpuc2	小精靈 / Newpuc2	小精靈 / Newpuc2	hack
newpuc2b	小精靈 / Newpuc2 (set 2)	小精靈 / Newpuc2 (set 2)	hack
newpuckx	小精靈 / New Puck-X	小精靈 / New Puck-X	hack
pacheart	小精靈 (Hearts)	小精靈 (Hearts)	hack
hangly	小精靈 / Hangly-Man (set 1)	小精靈 / Hangly-Man (set 1)	hack
hangly2	小精靈 / Hangly-Man (set 2)	小精靈 / Hangly-Man (set 2)	hack
hangly3	小精靈 / Hangly-Man (set 3)	小精靈 / Hangly-Man (set 3)	hack
piranhah	小精靈 / 食人魚 (hack)	小精靈 / 食人魚 (hack)	hack
abscam	小精靈 / Abscam	小精靈 / Abscam	GL (US Billiards License)
crush	頑皮鬼 (Kural Samno)	頑皮鬼 (Kural Samno)	Kural Samno Electric
crush2	頑皮鬼 (Kural Esco - 盜版?)	頑皮鬼 (Kural Esco - 盜版?)	Kural Esco Electric
crush3	頑皮鬼 (Kural - 盜版?)	頑皮鬼 (Kural - 盜版?)	Kural Electric
crush4	頑皮鬼 (Kural TWT)	頑皮鬼 (Kural TWT)	Kural TWT
maketrax	頑皮鬼 / Make Trax (set 1)	頑皮鬼 / Make Trax (set 1)	[Kural] (Williams license)
maketrxb	頑皮鬼 / Make Trax (set 2)	頑皮鬼 / Make Trax (set 2)	[Kural] (Williams license)
korosuke	頑皮鬼 / Korosuke Roller	頑皮鬼 / Korosuke Roller	Kural Electric
mbrush	頑皮鬼 / Magic Brush	頑皮鬼 / Magic Brush	bootleg
paintrlr	頑皮鬼 / Paint Roller	頑皮鬼 / Paint Roller	bootleg
pacplus	小精靈 Plus	小精靈 Plus	[Namco] (Midway license)
joyman	小精靈 / Joyman	小精靈 / Joyman	hack
ctrpllrp	小精靈 / Caterpillar Pacman Hack	小精靈 / Caterpillar Pacman Hack	hack
piranha	小精靈 / 食人魚	小精靈 / 食人魚	GL (US Billiards License)
piranhao	小精靈 / 食人魚 (舊版)	小精靈 / 食人魚 (舊版)	GL (US Billiards License)
mspacman	Ms. 小精靈	Ms. 小精靈	Midway
mspacmnf	Ms. 小精靈 (with speedup hack)	Ms. 小精靈 (with speedup hack)	Midway
mspacmat	Ms. 小精靈 / Ms. Pac Attack	Ms. 小精靈 / Ms. Pac Attack	hack
mspacmab	Ms. 小精靈 (盜版)	Ms. 小精靈 (盜版)	bootleg
mspacmbe	Ms. 小精靈 (盜版, 加密)	Ms. 小精靈 (盜版, 加密)	bootleg
pacgal	Ms. 小精靈 / Pac-Gal	Ms. 小精靈 / Pac-Gal	hack
mspacpls	Ms. 小精靈 Plus	Ms. 小精靈 Plus	hack
alibaba	阿里巴巴與 40 大盜	阿里巴巴與 40 大盜	Sega
mschamp	Ms. 小精靈 冠軍版 / Super Zola Pac Gal	Ms. 小精靈 冠軍版 / Super Zola Pac Gal	hack
pengo	企鵝推冰 (set 1 rev c)	企鵝推冰 (set 1 rev c)	Sega
pengo2	企鵝推冰 (set 2)	企鵝推冰 (set 2)	Sega
pengo2u	企鵝推冰 (set 2 未加密)	企鵝推冰 (set 2 未加密)	Sega
pengo3u	企鵝推冰 (set 3 未加密)	企鵝推冰 (set 3 未加密)	Sega
pengo4	企鵝推冰 (set 4)	企鵝推冰 (set 4)	Sega
pengob	企鵝推冰 (盜版)	企鵝推冰 (盜版)	bootleg
penta	企鵝推冰 / Penta	企鵝推冰 / Penta	bootleg
galaxian	小蜜蜂 (Namco set 1)	小蜜蜂 (Namco set 1)	Namco
galaxiaj	小蜜蜂 (Namco set 2)	小蜜蜂 (Namco set 2)	Namco
galmidw	小蜜蜂 (Midway)	小蜜蜂 (Midway)	[Namco] (Midway license)
galmidwo	小蜜蜂 (Midway, 舊版)	小蜜蜂 (Midway, 舊版)	[Namco] (Midway license)
superg	小蜜蜂 / 超級小蜜蜂	小蜜蜂 / 超級小蜜蜂	hack
galapx	小蜜蜂 Part X	小蜜蜂 Part X	hack
moonaln	小蜜蜂 / 月球異形	小蜜蜂 / 月球異形	[Nichibutsu] (Karateco license)
galap1	小蜜蜂 / Space Invaders Galactica	小蜜蜂 / Space Invaders Galactica	hack
galap4	小蜜蜂 / Galaxian Part 4	小蜜蜂 / Galaxian Part 4	hack
galturbo	小蜜蜂 / Galaxian Turbo	小蜜蜂 / Galaxian Turbo	hack
swarm	小蜜蜂 / 蜂群	小蜜蜂 / 蜂群	hack
zerotime	小蜜蜂 / Zero Time	小蜜蜂 / Zero Time	Petaco S.A.
starfght	小蜜蜂 / Star Fighter	小蜜蜂 / Star Fighter	Jeutel
tst_galx	小蜜蜂 / Galaxian Test ROM	小蜜蜂 / Galaxian Test ROM	Test ROM
uniwars	銀河帝國的逆襲 / UniWar S	銀河帝國的逆襲 / UniWar S	Irem
gteikoku	銀河帝國的逆襲	銀河帝國的逆襲	Irem
gteikokb	銀河帝國的逆襲 (盜版 set 1)	銀河帝國的逆襲 (盜版 set 1)	bootleg
gteikob2	銀河帝國的逆襲 (盜版 set 2)	銀河帝國的逆襲 (盜版 set 2)	bootleg
spacbatt	銀河帝國的逆襲 / Space Battle	銀河帝國的逆襲 / Space Battle	bootleg
skyraidr	銀河帝國的逆襲 / Sky Raiders	銀河帝國的逆襲 / Sky Raiders	bootleg
batman2	不死鳥 / 蝙蝠俠 Part 2	不死鳥 / 蝙蝠俠 Part 2	bootleg
pacmanbl	小精靈 (Galaxian hardware)	小精靈 (Galaxian hardware)	bootleg
devilfsg	魔魚 (Galaxian hardware, 盜版?)	魔魚 (Galaxian hardware, 盜版?)	Vision / Artic
zigzag	打空氣 / Zig Zag (Galaxian hardware, set 1)	打空氣 / Zig Zag (Galaxian hardware, set 1)	LAX
zigzag2	打空氣 / Zig Zag (Galaxian hardware, set 2)	打空氣 / Zig Zag (Galaxian hardware, set 2)	LAX
jumpbug	跳跳車	跳跳車	Rock-ola
jumpbugb	跳跳車 (盜版)	跳跳車 (盜版)	bootleg
moonal2	小蜜蜂 Part 2 / 月球異形 Part 2	小蜜蜂 Part 2 / 月球異形 Part 2	Nichibutsu
moonal2b	小蜜蜂 Part 2 / 月球異形 Part 2 (舊版)	小蜜蜂 Part 2 / 月球異形 Part 2 (舊版)	Nichibutsu
supergx	小蜜蜂 Part 2 / Super GX	小蜜蜂 Part 2 / Super GX	Nichibutsu
4in1	趣味四合一	趣味四合一	Armenia / Food and Fun
dkongjrm	小金剛 (Moon Cresta hardware)	小金剛 (Moon Cresta hardware)	bootleg
atlantis	決戰亞特蘭提斯 (set 1)	決戰亞特蘭提斯 (set 1)	Comsoft
atlants2	決戰亞特蘭提斯 (set 2)	決戰亞特蘭提斯 (set 2)	Comsoft
ckongs	瘋狂大金剛 (Scramble hardware)	瘋狂大金剛 (Scramble hardware)	bootleg
devilfsh	魔魚	魔魚	Artic
scobra	超級眼鏡蛇	超級眼鏡蛇	Konami
scobras	超級眼鏡蛇 (Stern)	超級眼鏡蛇 (Stern)	[Konami] (Stern license)
scobrase	超級眼鏡蛇 (Sega)	超級眼鏡蛇 (Sega)	[Konami] (Sega license)
scobrab	超級眼鏡蛇 (盜版)	超級眼鏡蛇 (盜版)	bootleg
armorcar	裝甲車 (set 1)	裝甲車 (set 1)	Stern
armorca2	裝甲車 (set 2)	裝甲車 (set 2)	Stern
moonwar	月球戰爭	月球戰爭	Stern
moonwara	月球戰爭 (舊)	月球戰爭 (舊)	Stern
darkplnt	黑暗星球	黑暗星球	Stern
cclimber	瘋狂攀登者 (美國版)	瘋狂攀登者 (美國版)	Nichibutsu
cclimbrj	瘋狂攀登者 (日本版)	瘋狂攀登者 (日本版)	Nichibutsu
ccboot	瘋狂攀登者 (盜版 set 1)	瘋狂攀登者 (盜版 set 1)	bootleg
ccboot2	瘋狂攀登者 (盜版 set 2)	瘋狂攀登者 (盜版 set 2)	bootleg
ckong	瘋狂大金剛 (set 1)	瘋狂大金剛 (set 1)	Falcon
ckonga	瘋狂大金剛 (set 2)	瘋狂大金剛 (set 2)	Falcon
ckongjeu	瘋狂大金剛 (Jeutel 盜版)	瘋狂大金剛 (Jeutel 盜版)	bootleg
ckongo	瘋狂大金剛 (Orca 盜版)	瘋狂大金剛 (Orca 盜版)	bootleg
ckongalc	瘋狂大金剛 (Alca 盜版)	瘋狂大金剛 (Alca 盜版)	bootleg
bigkong	瘋狂大金剛 / Big Kong	瘋狂大金剛 / Big Kong	bootleg
monkeyd	瘋狂大金剛 / Monkey Donkey	瘋狂大金剛 / Monkey Donkey	bootleg
yamato	大和號 (美國版)	大和號 (美國版)	Sega
yamato2	大和號 (世界版?)	大和號 (世界版?)	Sega
swimmer	游泳高手 (set 1)	游泳高手 (set 1)	Tehkan
swimmera	游泳高手  (set 2)	游泳高手  (set 2)	Tehkan
swimmerb	游泳高手  (set 3)	游泳高手  (set 3)	Tehkan
ckongb	瘋狂大金剛 (Alternative levels)	瘋狂大金剛 (Alternative levels)	bootleg
gomoku	五目連珠	五目連珠	Nichibutsu
magmax	金鋼合體	金鋼合體	Nichibutsu
terracre	火鳥戰機 (YM3526 set 1)	火鳥戰機 (YM3526 set 1)	Nichibutsu
terracrb	火鳥戰機 (YM3526 set 2)	火鳥戰機 (YM3526 set 2)	Nichibutsu
terracra	火鳥戰機 (YM2203)	火鳥戰機 (YM2203)	Nichibutsu
amazon	聖戰士 / Soldier Girl Amazon	聖戰士 / Soldier Girl Amazon	Nichibutsu
amatelas	聖戰士	聖戰士	Nichibutsu
dangar	UFO 變形金剛 (12/1/1986)	UFO 變形金剛 (12/1/1986)	Nichibutsu
dangar2	UFO 變形金剛 (9/26/1986)	UFO 變形金剛 (9/26/1986)	Nichibutsu
dangarb	UFO 變形金剛 (盜版)	UFO 變形金剛 (盜版)	bootleg
ninjemak	妖魔忍法帖 / Ninja Emaki (美國版)	妖魔忍法帖 / Ninja Emaki (美國版)	Nichibutsu
youma	妖魔忍法帖 (日本版)	妖魔忍法帖 (日本版)	Nichibutsu
legion	超時迷宮 (ver 2.03)	超時迷宮 (ver 2.03)	Nichibutsu
legiono	超時迷宮 (ver 1.05)	超時迷宮 (ver 1.05)	Nichibutsu
kodure	帶子狼 (日本版)	帶子狼 (日本版)	Nichibutsu
armedf	武裝編隊	武裝編隊	Nichibutsu
hyhoo	對戰問答 HYHOO (日本版)	對戰問答 HYHOO (日本版)	Nichibutsu
hyhoo2	對戰問答 HYHOO 2 (日本版)	對戰問答 HYHOO 2 (日本版)	Nichibutsu
pastelg	推倒胡 - 粉彩女郎 (日本版 851224)	推倒胡 - 粉彩女郎 (日本版 851224)	Nichibutsu
crystalg	水晶女孩 (日本版 860512)	水晶女孩 (日本版 860512)	Nichibutsu
crystal2	水晶女孩 2 (日本版 860620)	水晶女孩 2 (日本版 860620)	Nichibutsu
citylove	城市之戀 (日本版 860908)	城市之戀 (日本版 860908)	Nichibutsu
mcitylov	城市之戀 [BET] (日本版 860904)	城市之戀 [BET] (日本版 860904)	Nichibutsu
secolove	第二情人 (日本版 861201)	第二情人 (日本版 861201)	Nichibutsu
housemnq	對家麻濡感 - 誘惑日記篇 (日本版 870217)	對家麻濡感 - 誘惑日記篇 (日本版 870217)	Nichibutsu
housemn2	對家麻濡感 - 六本木實況編 (日本版 870418)	對家麻濡感 - 六本木實況編 (日本版 870418)	Nichibutsu
seiha	制霸 (日本版 870725)	制霸 (日本版 870725)	Nichibutsu
seiham	制霸 [BET] (日本版 870723)	制霸 [BET] (日本版 870723)	Nichibutsu
bijokkoy	美女夢物語 (日本版 870925)	美女夢物語 (日本版 870925)	Nichibutsu
iemoto	家元 (日本版 871020)	家元 (日本版 871020)	Nichibutsu
iemotom	家元 [BET] (日本版 871118)	家元 [BET] (日本版 871118)	Nichibutsu
ryuuha	流派 [BET] (日本版 871027)	流派 [BET] (日本版 871027)	Central Denshi
bijokkog	青春麻雀 - 美女學園 (日本版 880116)	青春麻雀 - 美女學園 (日本版 880116)	Nichibutsu
orangec	橙子俱樂部 - (秘) 課外授業 (日本版 880213)	橙子俱樂部 - (秘) 課外授業 (日本版 880213)	Daiichi Denshi
orangeci	橙子俱樂部 - (秘) 一發開放 [BET] (日本版 880221)	橙子俱樂部 - (秘) 一發開放 [BET] (日本版 880221)	Daiichi Denshi
vipclub	VIP 俱樂部 - (秘) 一發開放 [BET] (日本版 880310)	VIP 俱樂部 - (秘) 一發開放 [BET] (日本版 880310)	Daiichi Denshi
korinai	麻雀 愛玩無罪 (日本版 880425)	麻雀 愛玩無罪 (日本版 880425)	Nichibutsu
korinaim	麻雀 愛玩無罪 [BET] (日本版 880920)	麻雀 愛玩無罪 [BET] (日本版 880920)	Nichibutsu
kaguya	姬麻雀 [BET] (日本版 880521)	姬麻雀 [BET] (日本版 880521)	MIKI SYOUJI
kaguya2	姬麻雀 其之貳 [BET] (日本版 890829)	姬麻雀 其之貳 [BET] (日本版 890829)	MIKI SYOUJI
kaguya2f	姬麻雀 其之貳 復刻版 [BET] (日本版 010808)	姬麻雀 其之貳 復刻版 [BET] (日本版 010808)	MIKI SYOUJI
otonano	大人麻雀 (日本版 880628)	大人麻雀 (日本版 880628)	Apple
kanatuen	金津園 [BET] (日本版 880905)	金津園 [BET] (日本版 880905)	Panac
kyuhito	究極之女 [BET] (日本版 880824)	究極之女 [BET] (日本版 880824)	ROLLER TRON
mjsikaku	麻雀刺客 (日本版 880908)	麻雀刺客 (日本版 880908)	Nichibutsu
mjsikakb	麻雀刺客 (日本版 880722)	麻雀刺客 (日本版 880722)	Nichibutsu
mjsikakc	麻雀刺客 (日本版 880806)	麻雀刺客 (日本版 880806)	Nichibutsu
mjsikakd	麻雀刺客 (日本版 880802)	麻雀刺客 (日本版 880802)	Nichibutsu
mmsikaku	麻雀刺客 [BET] (日本版 880929)	麻雀刺客 [BET] (日本版 880929)	Nichibutsu
mjcamera	麻雀相機小僧 (set 1) (日本版 881109)	麻雀相機小僧 (set 1) (日本版 881109)	MIKI SYOUJI
mmcamera	麻雀相機小僧 / Mahjong Camera Kozou [BET] (日本版 890509)	麻雀相機小僧 / Mahjong Camera Kozou [BET] (日本版 890509)	MIKI SYOUJI
msjiken	麻雀殺人事件 (日本版 881017)	麻雀殺人事件 (日本版 881017)	Nichibutsu
hanamomo	麻雀刺客外傳 花之百子組 (日本版 881201)	麻雀刺客外傳 花之百子組 (日本版 881201)	Nichibutsu
hanamomb	麻雀刺客外傳 花之百子組 (日本版 881125)	麻雀刺客外傳 花之百子組 (日本版 881125)	Nichibutsu
telmahjn	電話麻雀 (日本版 890111)	電話麻雀 (日本版 890111)	Nichibutsu
taiwanmb	台灣麻雀 [BET] (日本版 881208)	台灣麻雀 [BET] (日本版 881208)	MIKI SYOUJI
gionbana	祇園花 (日本版 890120)	祇園花 (日本版 890120)	Nichibutsu
mgion	祇園花 [BET] (日本版 890207)	祇園花 [BET] (日本版 890207)	Nichibutsu
mjcamerb	麻雀相機小僧 (set 2) (日本版 881109)	麻雀相機小僧 (set 2) (日本版 881109)	MIKI SYOUJI
omotesnd	表參道 (日本版 890215)	表參道 (日本版 890215)	ANIME TEC
mjfocus	麻雀聚焦 (日本版 890313)	麻雀聚焦 (日本版 890313)	Nichibutsu
mjfocusm	麻雀聚焦 [BET] (日本版 890510)	麻雀聚焦 [BET] (日本版 890510)	Nichibutsu
peepshow	麻雀聚焦 / 麻雀西洋景 (日本版 890404)	麻雀聚焦 / 麻雀西洋景 (日本版 890404)	AC
mgmen89	麻雀 G-MEN '89 (日本版 890425)	麻雀 G-MEN '89 (日本版 890425)	Nichibutsu
pairsnb	電腦神經衰弱 (Nichibutsu) (日本版 890822)	電腦神經衰弱 (Nichibutsu) (日本版 890822)	Nichibutsu
pairsten	電腦神經衰弱 (System Ten) (日本版 890826)	電腦神經衰弱 (System Ten) (日本版 890826)	System Ten
bananadr	麻雀香蕉之夢 [BET] (日本版 891124)	麻雀香蕉之夢 [BET] (日本版 891124)	Digital Soft
mladyhtr	麻雀小姐獵手 - 怪盜黑貓聯盟篇 (日本版 900509)	麻雀小姐獵手 - 怪盜黑貓聯盟篇 (日本版 900509)	Nichibutsu
chinmoku	麻雀 沉默的編隊 (日本版 900511)	麻雀 沉默的編隊 (日本版 900511)	Nichibutsu
maiko	舞妓花 (日本版 900802)	舞妓花 (日本版 900802)	Nichibutsu
mmaiko	舞妓花 [BET] (日本版 900911)	舞妓花 [BET] (日本版 900911)	Nichibutsu
club90s	麻雀俱樂部 90' (set 1) (日本版 900919)	麻雀俱樂部 90' (set 1) (日本版 900919)	Nichibutsu
club90sa	麻雀俱樂部 90' (set 2) (日本版 900919)	麻雀俱樂部 90' (set 2) (日本版 900919)	Nichibutsu
lovehous	麻雀俱樂部 90' / 麻雀愛之屋 [BET] (日本版 901024)	麻雀俱樂部 90' / 麻雀愛之屋 [BET] (日本版 901024)	Nichibutsu
hanaoji	花與歐吉桑 [BET] (日本版 911209)	花與歐吉桑 [BET] (日本版 911209)	Nichibutsu
pstadium	麻雀 驚恐競技場 (日本版)	麻雀 驚恐競技場 (日本版)	Nichibutsu
triplew1	麻雀 三倍戰爭 (日本版)	麻雀 三倍戰爭 (日本版)	Nichibutsu
triplew2	麻雀 三倍戰爭 2 (日本版)	麻雀 三倍戰爭 2 (日本版)	Nichibutsu
ntopstar	瞄準! 頂尖巨星 - 藝能界生存麻雀 (日本版)	瞄準! 頂尖巨星 - 藝能界生存麻雀 (日本版)	Nichibutsu
mjlstory	麻雀實驗愛情故事 (日本版)	麻雀實驗愛情故事 (日本版)	Nichibutsu
vanilla	麻雀香草綜合症 (日本版)	麻雀香草綜合症 (日本版)	Nichibutsu
finalbny	麻雀 最後的兔女郎 [BET] (日本版)	麻雀 最後的兔女郎 [BET] (日本版)	Nichibutsu
qmhayaku	問答麻雀 早安! (日本版)	問答麻雀 早安! (日本版)	Nichibutsu
galkoku	麻雀 女孩的告白 (日本版)	麻雀 女孩的告白 (日本版)	Nichibutsu/T.R.TEC
hyouban	麻雀評判娘 [BET] (日本版)	麻雀評判娘 [BET] (日本版)	Nichibutsu/T.R.TEC
galkaika	麻雀 如花少女 (日本版)	麻雀 如花少女 (日本版)	Nichibutsu/T.R.TEC
tokyogal	東京女郎圖鑒 (日本版)	東京女郎圖鑒 (日本版)	Nichibutsu
tokimbsj	胸騷美少女 [BET] (日本版)	胸騷美少女 [BET] (日本版)	Nichibutsu
uchuuai	麻雀 來自宇宙的愛 (日本版)	麻雀 來自宇宙的愛 (日本版)	Nichibutsu
av2mj1bb	AV2 麻雀 No.1 海灣大橋的聖女 (日本版)	AV2 麻雀 No.1 海灣大橋的聖女 (日本版)	MIKI SYOUJI/AV JAPAN
av2mj2rg	AV2 麻雀 No.2 紅粉佳人 (日本版)	AV2 麻雀 No.2 紅粉佳人 (日本版)	MIKI SYOUJI/AV JAPAN
mjuraden	麻雀 占卜傳說 (日本版)	麻雀 占卜傳說 (日本版)	Nichibutsu/Yubis
koinomp	麻雀 戀愛的魔力 (日本版)	麻雀 戀愛的魔力 (日本版)	Nichibutsu
patimono	麻雀 柏青哥物語 (日本版)	麻雀 柏青哥物語 (日本版)	Nichibutsu
janbari	麻雀 認真峇里島 (日本版)	麻雀 認真峇里島 (日本版)	Nichibutsu/Yubis/AV JAPAN
mjanbari	獎章麻雀 認真峇里島 [BET] (日本版)	獎章麻雀 認真峇里島 [BET] (日本版)	Nichibutsu/Yubis/AV JAPAN
gal10ren	麻雀女郎 10 連發 (日本版)	麻雀女郎 10 連發 (日本版)	FUJIC
renaiclb	麻雀 戀愛俱樂部 (日本版)	麻雀 戀愛俱樂部 (日本版)	FUJIC
mjlaman	麻雀情緣 (日本版)	麻雀情緣 (日本版)	Nichibutsu/AV JAPAN
mkeibaou	麻雀 競馬王 (日本版)	麻雀 競馬王 (日本版)	Nichibutsu
pachiten	獎章麻雀 水果盤天國 [BET]  (日本版)	獎章麻雀 水果盤天國 [BET]  (日本版)	Nichibutsu/MIKI SYOUJI/AV JAPAN
sailorws	麻雀 水手之戰 (日本版)	麻雀 水手之戰 (日本版)	Nichibutsu
sailorwa	麻雀 水手之戰 (日本版) (set 2)	麻雀 水手之戰 (日本版) (set 2)	Nichibutsu
sailorwr	麻雀 水手之戰-R [BET] (日本版)	麻雀 水手之戰-R [BET] (日本版)	Nichibutsu
jituroku	實錄 (恥 )麻雀 - 巨大 H 告白篇 (日本版)	實錄 (恥 )麻雀 - 巨大 H 告白篇 (日本版)	Windom
yosimoto	麻雀 吉本劇場 (日本版)	麻雀 吉本劇場 (日本版)	Nichibutsu/Yoshimoto Kougyou
psailor1	美少女雀士 漂亮水手 18 禁 (日本版)	美少女雀士 漂亮水手 18 禁 (日本版)	SPHINX
psailor2	美少女雀士 漂亮水手 2 (日本版)	美少女雀士 漂亮水手 2 (日本版)	SPHINX
otatidai	迪斯可麻雀 (日本版)	迪斯可麻雀 (日本版)	SPHINX
ngpgal	熱血賽車女郎 (日本版)	熱血賽車女郎 (日本版)	Nichibutsu
mjgottsu	麻雀 身歷其境! (日本版)	麻雀 身歷其境! (日本版)	Nichibutsu
bakuhatu	麻雀 爆發純情傳 (日本版)	麻雀 爆發純情傳 (日本版)	Nichibutsu
cmehyou	麻雀巡回女豹 (日本版)	麻雀巡回女豹 (日本版)	Nichibutsu/Kawakusu
mmehyou	獎章麻雀 巡回女豹 [BET]  (日本版)	獎章麻雀 巡回女豹 [BET]  (日本版)	Nichibutsu/Kawakusu
mjkoiura	麻雀 戀愛占卜 (日本版)	麻雀 戀愛占卜 (日本版)	Nichibutsu
mkoiuraa	麻雀 戀愛占卜 (set 2) (日本版)	麻雀 戀愛占卜 (set 2) (日本版)	Nichibutsu
imekura	瘋狂麻雀 (日本版)	瘋狂麻雀 (日本版)	SPHINX/AV JAPAN
mscoutm	麻雀偵察員 - 潛入!! AV 攝影現場 (日本版)	麻雀偵察員 - 潛入!! AV 攝影現場 (日本版)	SPHINX/AV JAPAN
mjegolf	麻雀美女高爾夫 (日本版)	麻雀美女高爾夫 (日本版)	FUJIC/AV JAPAN
mhhonban	麻雀放送局 本番中 (日本版)	麻雀放送局 本番中 (日本版)	Nichibutsu?
musobana	夢想花 (日本版)	夢想花 (日本版)	Nichibutsu/Yubis
niyanpai	娘牌 (日本版)	娘牌 (日本版)	Nichibutsu
phoenix	不死鳥 (Amstar)	不死鳥 (Amstar)	Amstar
phoenixa	不死鳥 (Centuri)	不死鳥 (Centuri)	Amstar (Centuri license)
phoenixt	不死鳥 (Taito)	不死鳥 (Taito)	Taito
phoenix3	不死鳥 (T.P.N.)	不死鳥 (T.P.N.)	bootleg
phoenixc	不死鳥 (IRECSA, G.G.I Corp)	不死鳥 (IRECSA, G.G.I Corp)	bootleg?
condor	不死鳥 / Condor	不死鳥 / Condor	Sidam
falcon	不死鳥 / Falcon (盜版 set 1)	不死鳥 / Falcon (盜版 set 1)	bootleg
vautour	不死鳥 / Vautour (set 1 - Jeutel 法國版)	不死鳥 / Vautour (set 1 - Jeutel 法國版)	bootleg
vautour2	不死鳥 / Vautour (set 2)	不死鳥 / Vautour (set 2)	bootleg
griffon	不死鳥 / Griffon	不死鳥 / Griffon	Videotron
falcona	不死鳥 / Falcon (盜版 set 2)	不死鳥 / Falcon (盜版 set 2)	bootleg
kaitei	海底探寶	海底探寶	Namco
kaiteik	海底探寶 (K'K-Tokki)	海底探寶 (K'K-Tokki)	K.K. Tokki
tankbatt	坦克部隊	坦克部隊	Namco
rallyx	迷魂車 X	迷魂車 X	Namco
rallyxm	迷魂車 X (Midway)	迷魂車 X (Midway)	[Namco] (Midway license)
nrallyx	新迷魂車 X	新迷魂車 X	Namco
galaga	大蜜蜂 (Namco rev. B)	大蜜蜂 (Namco rev. B)	Namco
galagao	大蜜蜂 (Namco)	大蜜蜂 (Namco)	Namco
galagamw	大蜜蜂 (Midway set 1)	大蜜蜂 (Midway set 1)	[Namco] (Midway license)
galagamk	大蜜蜂 (Midway set 2)	大蜜蜂 (Midway set 2)	[Namco] (Midway license)
gallag	大蜜蜂 / Gallag	大蜜蜂 / Gallag	bootleg
gatsbee	大蜜蜂 / Gatsbee	大蜜蜂 / Gatsbee	hack
digdug	打空氣 (rev 2)	打空氣 (rev 2)	Namco
digdugb	打空氣 (rev 1)	打空氣 (rev 1)	Namco
digdugat	打空氣 (Atari, rev 2)	打空氣 (Atari, rev 2)	[Namco] (Atari license)
digduga1	打空氣 (Atari, rev 1)	打空氣 (Atari, rev 1)	[Namco] (Atari license)
dzigzag	打空氣 / Zig Zag (Dig Dug hardware)	打空氣 / Zig Zag (Dig Dug hardware)	bootleg
xevious	鐵板陣 (Namco)	鐵板陣 (Namco)	Namco
xeviousa	鐵板陣 (Atari set 1)	鐵板陣 (Atari set 1)	Namco (Atari license)
xeviousb	鐵板陣 (Atari set 2)	鐵板陣 (Atari set 2)	Namco (Atari license)
xeviousc	鐵板陣 (Atari set 3)	鐵板陣 (Atari set 3)	Namco (Atari license)
xevios	鐵板陣 / Xevios	鐵板陣 / Xevios	bootleg
battles	鐵板陣 / Battles	鐵板陣 / Battles	bootleg
sxevious	超級鐵板陣	超級鐵板陣	Namco
superpac	超級小精靈	超級小精靈	Namco
superpcm	超級小精靈 (Midway)	超級小精靈 (Midway)	[Namco] (Bally Midway license)
pacnpal	小精靈 & 小精靈 / Pac & Pal	小精靈 & 小精靈 / Pac & Pal	Namco
pacnpal2	小精靈 & 小精靈 / Pac & Pal (舊)	小精靈 & 小精靈 / Pac & Pal (舊)	Namco
pacnchmp	小精靈 & 小精靈 / Pac-Man & Chomp Chomp	小精靈 & 小精靈 / Pac-Man & Chomp Chomp	Namco
mappy	貓捉老鼠 (美國版)	貓捉老鼠 (美國版)	Namco
mappyj	貓捉老鼠 (日本版)	貓捉老鼠 (日本版)	Namco
digdug2	打空氣 II (新版)	打空氣 II (新版)	Namco
digdug2o	打空氣 II (舊版)	打空氣 II (舊版)	Namco
todruaga	迷宮塔 (新版)	迷宮塔 (新版)	Namco
todruago	迷宮塔 (舊版)	迷宮塔 (舊版)	Namco
grobda	坦克車 (新版)	坦克車 (新版)	Namco
grobda2	坦克車 (舊版 set 1)	坦克車 (舊版 set 1)	Namco
grobda3	坦克車 (舊版 set 2)	坦克車 (舊版 set 2)	Namco
gaplus	大蜜蜂 3 / Gaplus (rev. D)	大蜜蜂 3 / Gaplus (rev. D)	Namco
gaplusa	大蜜蜂 3 / Gaplus (alternate hardware)	大蜜蜂 3 / Gaplus (alternate hardware)	Namco
gapluso	大蜜蜂 3 / Gaplus (rev. B)	大蜜蜂 3 / Gaplus (rev. B)	Namco
galaga3	大蜜蜂 3 (rev. C)	大蜜蜂 3 (rev. C)	Namco
galaga3m	大蜜蜂 3 (set 3)	大蜜蜂 3 (set 3)	Namco
galaga3a	大蜜蜂 3 (set 2)	大蜜蜂 3 (set 2)	Namco
polepos	頂尖賽手 / Pole Position	頂尖賽手 / Pole Position	Namco
poleposa	頂尖賽手 / Pole Position (Atari version 2)	頂尖賽手 / Pole Position (Atari version 2)	Namco (Atari license)
polepos1	頂尖賽手 / Pole Position (Atari version 1)	頂尖賽手 / Pole Position (Atari version 1)	[Namco] (Atari license)
topracer	頂尖賽手 (set 1)	頂尖賽手 (set 1)	bootleg
topracra	頂尖賽手 (set 2)	頂尖賽手 (set 2)	bootleg
topracrb	頂尖賽手 (set 3)	頂尖賽手 (set 3)	bootleg
polepos2	頂尖賽手 II / Pole Position II	頂尖賽手 II / Pole Position II	Namco
poleps2a	頂尖賽手 II / Pole Position II (Atari)	頂尖賽手 II / Pole Position II (Atari)	Namco (Atari license)
poleps2b	頂尖賽手 II / Pole Position II (盜版)	頂尖賽手 II / Pole Position II (盜版)	bootleg
pacland	小精靈探險 (set 1)	小精靈探險 (set 1)	Namco
pacland2	小精靈探險 (set 2)	小精靈探險 (set 2)	Namco
pacland3	小精靈探險 (set 3)	小精靈探險 (set 3)	Namco
paclandm	小精靈探險 (Midway)	小精靈探險 (Midway)	[Namco] (Bally Midway license)
skykid	天空小子 (新版)	天空小子 (新版)	Namco
skykido	天空小子 (舊版)	天空小子 (舊版)	Namco
skykidd	天空小子 (60A1 Ver.)	天空小子 (60A1 Ver.)	Namco
metrocrs	障礙賽跑 (set 1)	障礙賽跑 (set 1)	Namco
metrocra	障礙賽跑 (set 2)	障礙賽跑 (set 2)	Namco
skykiddx	天空小子 DELUXE (set 1)	天空小子 DELUXE (set 1)	Namco
skykiddo	天空小子 DELUXE (set 2)	天空小子 DELUXE (set 2)	Namco
genpeitd	源平討魔傳	源平討魔傳	Namco
rthunder	滾雷 (新版)	滾雷 (新版)	Namco
rthundro	滾雷 (舊版)	滾雷 (舊版)	Namco
wndrmomo	神奇女孩	神奇女孩	Namco
shadowld	妖怪道中記 / Shadowland	妖怪道中記 / Shadowland	Namco
youkaidk	妖怪道中記 (日本版 新版)	妖怪道中記 (日本版 新版)	Namco
yokaidko	妖怪道中記 (日本版 舊版)	妖怪道中記 (日本版 舊版)	Namco
dspirit	龍魂 (新版)	龍魂 (新版)	Namco
dspirito	龍魂 (舊版)	龍魂 (舊版)	Namco
pacmania	3D 小精靈	3D 小精靈	Namco
pacmanij	3D 小精靈 (日本版)	3D 小精靈 (日本版)	Namco
galaga88	大蜜蜂 '88	大蜜蜂 '88	Namco
galag88j	大蜜蜂 '88 (日本版)	大蜜蜂 '88 (日本版)	Namco
ws	世界競技場 (日本版)	世界競技場 (日本版)	Namco
berabohm	超絕倫人 (日本版 version C)	超絕倫人 (日本版 version C)	Namco
beraboho	超絕倫人 (日本版 version B)	超絕倫人 (日本版 version B)	Namco
bakutotu	暴突機銃艇	暴突機銃艇	Namco
wldcourt	世界網球 (日本版)	世界網球 (日本版)	Namco
splatter	鬼屋 (世界版)	鬼屋 (世界版)	Namco
splattej	鬼屋 (日本版)	鬼屋 (日本版)	Namco
ws89	世界棒球 '89 (日本版)	世界棒球 '89 (日本版)	Namco
dangseed	危機四伏 (日本版)	危機四伏 (日本版)	Namco
ws90	世界棒球 '90 (日本版)	世界棒球 '90 (日本版)	Namco
pistoldm	手槍大名的冒險 (日本版)	手槍大名的冒險 (日本版)	Namco
boxyboy	倉庫番 / Boxy Boy (美國版)	倉庫番 / Boxy Boy (美國版)	Namco
soukobdx	倉庫番 (日本版)	倉庫番 (日本版)	Namco
puzlclub	解謎俱樂部 (日本版 開發版)	解謎俱樂部 (日本版 開發版)	Namco
tankfrce	坦克大戰 (美國版)	坦克大戰 (美國版)	Namco
tankfrcj	坦克大戰 (日本版)	坦克大戰 (日本版)	Namco
ordyne	歐坦救美 (日本版, 英文版)	歐坦救美 (日本版, 英文版)	Namco
ordynej	歐坦救美 (日本版)	歐坦救美 (日本版)	Namco
mirninja	未來忍者 (日本版)	未來忍者 (日本版)	Namco
kyukaidk	球界道中記 (日本版 新版)	球界道中記 (日本版 新版)	Namco
kyukaido	球界道中記 (日本版 舊版)	球界道中記 (日本版 舊版)	Namco
rthun2	滾雷 2	滾雷 2	Namco
rthun2j	滾雷 2 (日本版)	滾雷 2 (日本版)	Namco
sws	超級世界棒球 (日本版)	超級世界棒球 (日本版)	Namco
sws92	超級世界棒球 '92 (日本版)	超級世界棒球 '92 (日本版)	Namco
sws92g	超級世界棒球 '92 激鬥版 (日本版)	超級世界棒球 '92 激鬥版 (日本版)	Namco
sws93	超級世界棒球 '93 激鬥版 (日本版)	超級世界棒球 '93 激鬥版 (日本版)	Namco
bkrtmaq	爆裂問答 魔Q大冒險 (日本版)	爆裂問答 魔Q大冒險 (日本版)	Namco
fghtatck	F/A / Fighter & Attacker (美國版)	F/A / Fighter & Attacker (美國版)	Namco
fa	F/A (日本版)	F/A (日本版)	Namco
quiztou	熱鬥! 激鬥! 問題島!! (日本版)	熱鬥! 激鬥! 問題島!! (日本版)	Namco
xday2	X-DAY 2 (日本版)	X-DAY 2 (日本版)	Namco
ptblank	槍林彈雨 / Point Blank	槍林彈雨 / Point Blank	Namco
gunbulet	槍林彈雨 (日本版)	槍林彈雨 (日本版)	Namco
gslugrsj	超級強打 (日本版)	超級強打 (日本版)	Namco
gslgr94u	超級強打 '94	超級強打 '94	Namco
sws95	超級世界棒球 '95 (日本版)	超級世界棒球 '95 (日本版)	Namco
sws96	超級世界棒球 '96 (日本版)	超級世界棒球 '96 (日本版)	Namco
sws97	超級世界棒球 '97 (日本版)	超級世界棒球 '97 (日本版)	Namco
ncv1	Namco 名作劇場 Vol.1	Namco 名作劇場 Vol.1	Namco
ncv1j	Namco 名作劇場 Vol.1 (日本版, v1.00)	Namco 名作劇場 Vol.1 (日本版, v1.00)	Namco
ncv1j2	Namco 名作劇場 Vol.1 (日本版, v1.03)	Namco 名作劇場 Vol.1 (日本版, v1.03)	Namco
ncv2	Namco 名作劇場 Vol.2	Namco 名作劇場 Vol.2	Namco
ncv2j	Namco 名作劇場 Vol.2 (日本版)	Namco 名作劇場 Vol.2 (日本版)	Namco
ridgerac	實感賽車 (Rev. RR2, 世界版)	實感賽車 (Rev. RR2, 世界版)	Namco
ridgeraj	實感賽車 (Rev. RR1, 日本版)	實感賽車 (Rev. RR1, 日本版)	Namco
acedrvrw	A 式賽車 (Rev. AD2, 世界版)	A 式賽車 (Rev. AD2, 世界版)	Namco
alpinerd	阿爾卑斯滑雪 (Rev. AR2 Ver.D)	阿爾卑斯滑雪 (Rev. AR2 Ver.D)	Namco
alpinerc	阿爾卑斯滑雪 (Rev. AR2 Ver.C)	阿爾卑斯滑雪 (Rev. AR2 Ver.C)	Namco
ridgera2	實感賽車 2 (Rev. RRS2, 美國版)	實感賽車 2 (Rev. RRS2, 美國版)	Namco
ridger2a	實感賽車 2 (Rev. RRS1, Ver.B, 日本版)	實感賽車 2 (Rev. RRS1, Ver.B, 日本版)	Namco
ridger2b	實感賽車 2 (Rev. RRS1, 日本版)	實感賽車 2 (Rev. RRS1, 日本版)	Namco
raveracw	巔峰賽車 (Rev. RV2, 世界版)	巔峰賽車 (Rev. RV2, 世界版)	Namco
raveracj	巔峰賽車 (Rev. RV1 Ver.B, 日本版)	巔峰賽車 (Rev. RV1 Ver.B, 日本版)	Namco
raveraja	巔峰賽車 (Rev. RV1, 日本版)	巔峰賽車 (Rev. RV1, 日本版)	Namco
alpinr2b	阿爾卑斯滑雪 2 (Rev. ARS2 Ver.B)	阿爾卑斯滑雪 2 (Rev. ARS2 Ver.B)	Namco
victlapw	A 式賽車: 勝利賽車 (Rev. ADV2, 世界版)	A 式賽車: 勝利賽車 (Rev. ADV2, 世界版)	Namco
redclash	赤色衝擊 (set 1)	赤色衝擊 (set 1)	Tehkan
redclsha	赤色衝擊 (set 2)	赤色衝擊 (set 2)	Tehkan
redclask	赤色衝擊 (Kaneko)	赤色衝擊 (Kaneko)	Kaneko
devzone	魔鬼地帶	魔鬼地帶	Universal
devzone2	魔鬼地帶 (easier)	魔鬼地帶 (easier)	Universal
nomnlnd	戰國自衛隊 / No Man's Land	戰國自衛隊 / No Man's Land	Universal
nomnlndg	戰國自衛隊 / No Man's Land (Gottlieb)	戰國自衛隊 / No Man's Land (Gottlieb)	Universal (Gottlieb license)
mrdo	杜先生!	杜先生!	Universal
mrdoy	杜先生! (開發版)	杜先生! (開發版)	Universal
mrdot	杜先生! (Taito)	杜先生! (Taito)	Universal (Taito license)
mrdofix	杜先生! (bugfixed)	杜先生! (bugfixed)	Universal (Taito license)
mrlo	杜先生! / Mr. Lo!	杜先生! / Mr. Lo!	bootleg
mrdu	杜先生! / Mr. Du!	杜先生! / Mr. Du!	bootleg
yankeedo	杜先生! / Yankee DO!	杜先生! / Yankee DO!	hack
docastle	杜先生 vs. 獨角獸 / Mr. Do's Castle (set 1)	杜先生 vs. 獨角獸 / Mr. Do's Castle (set 1)	Universal
docastl2	杜先生 vs. 獨角獸 / Mr. Do's Castle (set 2)	杜先生 vs. 獨角獸 / Mr. Do's Castle (set 2)	Universal
docastlo	杜先生 vs. 獨角獸 / Mr. Do's Castle (舊)	杜先生 vs. 獨角獸 / Mr. Do's Castle (舊)	Universal
douni	杜先生 vs. 獨角獸	杜先生 vs. 獨角獸	Universal
dowild	杜先生的暴走	杜先生的暴走	Universal
helifire	太陽火 (set 1)	太陽火 (set 1)	Nintendo
helifira	太陽火 (set 2)	太陽火 (set 2)	Nintendo
dkong	大金剛 (美國版 set 1)	大金剛 (美國版 set 1)	Nintendo of America
dkongo	大金剛 (美國版 set 2)	大金剛 (美國版 set 2)	Nintendo
dkongjp	大金剛 (日本版 set 1)	大金剛 (日本版 set 1)	Nintendo
dkongjo	大金剛 (日本版 set 2)	大金剛 (日本版 set 2)	Nintendo
dkongjo1	大金剛 (日本版 set 3) (bad dump?)	大金剛 (日本版 set 3) (bad dump?)	Nintendo
dkongjr	小金剛 / Donkey Kong Junior (美國版)	小金剛 / Donkey Kong Junior (美國版)	Nintendo of America
dkongjrj	小金剛 (日本版)	小金剛 (日本版)	Nintendo
dkngjnrj	小金剛 / Donkey Kong Junior (日本版?)	小金剛 / Donkey Kong Junior (日本版?)	Nintendo
dkongjrb	小金剛 (盜版)	小金剛 (盜版)	bootleg
dkngjnrb	小金剛 / Donkey Kong Junior (盜版?)	小金剛 / Donkey Kong Junior (盜版?)	Nintendo of America
dkong3	大金剛 3 (美國版)	大金剛 3 (美國版)	Nintendo of America
dkong3j	大金剛 3 (日本版)	大金剛 3 (日本版)	Nintendo
dkong3b	大金剛 3 (盜版 Donkey Kong Jr. hardware)	大金剛 3 (盜版 Donkey Kong Jr. hardware)	bootleg
mario	馬利歐兄弟 (美國版)	馬利歐兄弟 (美國版)	Nintendo of America
mariojp	馬利歐兄弟 (日本版)	馬利歐兄弟 (日本版)	Nintendo
masao	馬利歐兄弟 / Masao	馬利歐兄弟 / Masao	bootleg
pestplce	馬利歐兄弟 / Pest Place	馬利歐兄弟 / Pest Place	bootleg
popeye	大力水手 (revision D)	大力水手 (revision D)	Nintendo
popeyeu	大力水手 (revision D not protected)	大力水手 (revision D not protected)	Nintendo
popeyef	大力水手 (revision F)	大力水手 (revision F)	Nintendo
popeyebl	大力水手 (盜版)	大力水手 (盜版)	bootleg
pc_tenis	網球 (PlayChoice-10)	網球 (PlayChoice-10)	Nintendo
pc_mario	馬利歐兄弟 (PlayChoice-10)	馬利歐兄弟 (PlayChoice-10)	Nintendo
pc_bball	棒球 (PlayChoice-10)	棒球 (PlayChoice-10)	Nintendo of America
pc_golf	高爾夫 (PlayChoice-10)	高爾夫 (PlayChoice-10)	Nintendo
pc_kngfu	成龍踢館 / 功夫 (PlayChoice-10)	成龍踢館 / 功夫 (PlayChoice-10)	Irem (Nintendo license)
pc_smb	超級馬利歐兄弟 (PlayChoice-10)	超級馬利歐兄弟 (PlayChoice-10)	Nintendo
pc_vball	排球 (PlayChoice-10)	排球 (PlayChoice-10)	Nintendo
pc_trjan	鬥者輓歌 / Trojan (PlayChoice-10)	鬥者輓歌 / Trojan (PlayChoice-10)	Capcom USA (Nintendo of America license)
pc_cvnia	惡魔城 / Castlevania (PlayChoice-10)	惡魔城 / Castlevania (PlayChoice-10)	Konami (Nintendo of America license)
pc_rnatk	綠色兵團 / Rush'n Attack (PlayChoice-10)	綠色兵團 / Rush'n Attack (PlayChoice-10)	Konami (Nintendo of America license)
pc_rygar	未來戰士 / Rygar (PlayChoice-10)	未來戰士 / Rygar (PlayChoice-10)	Tecmo (Nintendo of America license)
pc_cntra	魂斗羅 / Contra (PlayChoice-10)	魂斗羅 / Contra (PlayChoice-10)	Konami (Nintendo of America license)
pc_ngaid	忍者龍劍傳 / Ninja Gaiden (PlayChoice-10)	忍者龍劍傳 / Ninja Gaiden (PlayChoice-10)	Tecmo (Nintendo of America license)
pc_tmnt	忍者龜 / Teenage Mutant Ninja Turtles (PlayChoice-10)	忍者龜 / Teenage Mutant Ninja Turtles (PlayChoice-10)	Konami (Nintendo of America license)
pc_bstar	棒球之星 (PlayChoice-10)	棒球之星 (PlayChoice-10)	SNK (Nintendo of America license)
pc_drmro	馬利歐醫生 (PlayChoice-10)	馬利歐醫生 (PlayChoice-10)	Nintendo
pc_ynoid	假面忍者花丸 / Yo! Noid (PlayChoice-10)	假面忍者花丸 / Yo! Noid (PlayChoice-10)	Capcom USA (Nintendo of America license)
pc_ddrgn	雙截龍 (PlayChoice-10)	雙截龍 (PlayChoice-10)	Technos
pc_gntlt	聖鎧傳說 (PlayChoice-10)	聖鎧傳說 (PlayChoice-10)	Atari/Tengen (Nintendo of America license)
pc_smb2	超級馬利歐兄弟 2 (PlayChoice-10)	超級馬利歐兄弟 2 (PlayChoice-10)	Nintendo
pc_smb3	超級馬利歐兄弟 3 (PlayChoice-10)	超級馬利歐兄弟 3 (PlayChoice-10)	Nintendo
pc_mman3	洛克人 III / Mega Man III (PlayChoice-10)	洛克人 III / Mega Man III (PlayChoice-10)	Capcom USA (Nintendo of America license)
pc_suprc	超級魂斗羅 / Super C (PlayChoice-10)	超級魂斗羅 / Super C (PlayChoice-10)	Konami (Nintendo of America license)
pc_tmnt2	忍者龜 II / Teenage Mutant Ninja Turtles II: The Arcade Game (PlayChoice-10)	忍者龜 II / Teenage Mutant Ninja Turtles II: The Arcade Game (PlayChoice-10)	Konami (Nintendo of America license)
pc_wcup	熱血高校躲避球 / Nintendo World Cup (PlayChoice-10)	熱血高校躲避球 / Nintendo World Cup (PlayChoice-10)	Technos (Nintendo license)
pc_ngai2	忍者龍劍傳 II - 暗黑的邪神劍 / Ninja Gaiden Episode II: The Dark Sword of Chaos (PlayChoice-10)	忍者龍劍傳 II - 暗黑的邪神劍 / Ninja Gaiden Episode II: The Dark Sword of Chaos (PlayChoice-10)	Tecmo (Nintendo of America license)
pc_ngai3	忍者龍劍傳 III - 黃泉的方船 / Ninja Gaiden Episode III: The Ancient Ship of Doom (PlayChoice-10)	忍者龍劍傳 III - 黃泉的方船 / Ninja Gaiden Episode III: The Ancient Ship of Doom (PlayChoice-10)	Tecmo (Nintendo of America license)
pc_moglf	馬利歐的戶外高爾夫 (PlayChoice-10)	馬利歐的戶外高爾夫 (PlayChoice-10)	Nintendo
cstlevna	Vs. 惡魔城 / Vs. Castlevania	Vs. 惡魔城 / Vs. Castlevania	Konami
drmario	Vs. 馬利歐醫生	Vs. 馬利歐醫生	Nintendo
rbibb	Vs. Atari R.B.I. 棒球 (set 1)	Vs. Atari R.B.I. 棒球 (set 1)	Namco
rbibba	Vs. Atari R.B.I. 棒球 (set 2)	Vs. Atari R.B.I. 棒球 (set 2)	Namco
suprmrio	Vs. 超級馬利歐兄弟	Vs. 超級馬利歐兄弟	Nintendo
vsskykid	Vs. 天空小子 / Vs. Super SkyKid	Vs. 天空小子 / Vs. Super SkyKid	Namco
vspinbal	Vs. 彈珠檯	Vs. 彈珠檯	Nintendo
vspinblj	Vs. 彈珠檯 (日本版)	Vs. 彈珠檯 (日本版)	Nintendo
vsslalom	Vs. 障礙滑雪賽	Vs. 障礙滑雪賽	Rare LTD.
vssoccer	Vs. 足球	Vs. 足球	Nintendo
vstetris	Vs. 俄羅斯方塊	Vs. 俄羅斯方塊	Academysoft-Elory
topgun	Vs. 捍衛戰士	Vs. 捍衛戰士	Konami
vstennis	Vs. 網球	Vs. 網球	Nintendo
vstennij	Vs. 網球 (日本版)	Vs. 網球 (日本版)	Nintendo
vsmahjng	Vs. 麻雀 (日本版)	Vs. 麻雀 (日本版)	Nintendo
vsbball	Vs. 棒球	Vs. 棒球	Nintendo of America
vsbballj	Vs. 棒球 (日本版 set 1)	Vs. 棒球 (日本版 set 1)	Nintendo of America
vsbbalja	Vs. 棒球 (日本版 set 2)	Vs. 棒球 (日本版 set 2)	Nintendo of America
supxevs	Vs. 超級鐵板陣	Vs. 超級鐵板陣	Namco
vsbbaljb	Vs. 棒球 (日本版 set 3)	Vs. 棒球 (日本版 set 3)	Nintendo of America
nss_ssoc	超級足球 / Super Soccer (Nintendo Super System)	超級足球 / Super Soccer (Nintendo Super System)	Human Inc.
nss_con3	魂斗羅 3: 異形戰爭 / Contra 3: The Alien Wars (Nintendo Super System)	魂斗羅 3: 異形戰爭 / Contra 3: The Alien Wars (Nintendo Super System)	Konami
nss_ncaa	NCAA 大學籃球 (Nintendo Super System)	NCAA 大學籃球 (Nintendo Super System)	Sculptured Software Inc.
nss_smw	超級馬利歐世界 (Nintendo Super System)	超級馬利歐世界 (Nintendo Super System)	Nintendo
nss_sten	超級網球 / Super Tennis (Nintendo Super System)	超級網球 / Super Tennis (Nintendo Super System)	Nintendo
seawolf	海狼	海狼	Midway
maze	奇異迷宮	奇異迷宮	Midway
desertgu	沙漠槍手	沙漠槍手	Midway
phantom2	幻影 II	幻影 II	Midway
bowler	4 人保齡球	4 人保齡球	Midway
invaders	太空入侵者	太空入侵者	Midway
invad2ct	太空入侵者 II (Midway, 檯面型)	太空入侵者 II (Midway, 檯面型)	Midway
invadpt2	太空入侵者 Part II (Taito)	太空入侵者 Part II (Taito)	Taito
invaddlx	太空入侵者 Part II / 太空入侵者 Deluxe	太空入侵者 Part II / 太空入侵者 Deluxe	Midway
moonbase	太空入侵者 Part II / Moon Base	太空入侵者 Part II / Moon Base	Nichibutsu
searthin	太空入侵者 / Super Earth Invasion (set 1)	太空入侵者 / Super Earth Invasion (set 1)	bootleg
searthia	太空入侵者 / Super Earth Invasion (set 2)	太空入侵者 / Super Earth Invasion (set 2)	bootleg
invadrmr	太空入侵者 (Model Racing)	太空入侵者 (Model Racing)	Model Racing
spaceatt	太空入侵者 / 太空攻擊	太空入侵者 / 太空攻擊	Video Games GMBH
spaceat2	太空入侵者 / 太空攻擊 II	太空入侵者 / 太空攻擊 II	Zenitone-Microsec Ltd
sinvzen	太空入侵者 / Super Invaders (Zenitone-Microsec)	太空入侵者 / Super Invaders (Zenitone-Microsec)	Zenitone-Microsec Ltd
superinv	太空入侵者 / Super Invaders	太空入侵者 / Super Invaders	bootleg
invasion	太空入侵者 / Invasion	太空入侵者 / Invasion	Sidam
sstrangr	太空生物	太空生物	Yachiyo Electronics, Ltd.
sstrngr2	太空生物 2	太空生物 2	Yachiyo Electronics, Ltd.
sinvemag	太空入侵者 / Super Invaders (EMAG)	太空入侵者 / Super Invaders (EMAG)	bootleg
jspecter	太空入侵者 / Jatre Specter (set 1)	太空入侵者 / Jatre Specter (set 1)	Jatre
jspectr2	太空入侵者 / Jatre Specter (set 2)	太空入侵者 / Jatre Specter (set 2)	Jatre
invrvnge	入侵者復仇	入侵者復仇	Zenitone-Microsec Ltd.
invrvnga	入侵者復仇 (Dutchford)	入侵者復仇 (Dutchford)	Zenitone-Microsec Ltd. (Dutchford license)
galxwars	銀河戰爭 (Universal set 1)	銀河戰爭 (Universal set 1)	Universal
galxwar2	銀河戰爭 (Universal set 2)	銀河戰爭 (Universal set 2)	Universal
galxwart	銀河戰爭 (Taito?)	銀河戰爭 (Taito?)	Taito?
starw	銀河戰爭 / Star Wars	銀河戰爭 / Star Wars	bootleg
lrescue	月球營救	月球營救	Taito
grescue	月球營救 / Galaxy Rescue	月球營救 / Galaxy Rescue	Taito (Universal license?)
desterth	月球營救 / Destination Earth	月球營救 / Destination Earth	bootleg
cosmicmo	太空入侵者 / 宇宙怪物	太空入侵者 / 宇宙怪物	Universal
cosmicm2	太空入侵者 / 宇宙怪物 2	太空入侵者 / 宇宙怪物 2	Universal
ozmawars	Ozma 戰爭 (set 1)	Ozma 戰爭 (set 1)	SNK
ozmawar2	Ozma 戰爭 (set 2)	Ozma 戰爭 (set 2)	SNK
solfight	Ozma 戰爭 / 太陽戰鬥	Ozma 戰爭 / 太陽戰鬥	bootleg
spaceph	Ozma 戰爭 / 宇宙幻影	Ozma 戰爭 / 宇宙幻影	Zilec Games
lupin3	魯邦三世	魯邦三世	Taito
spclaser	太空雷射	太空雷射	GamePlan (Taito)
laser	太空雷射 / Laser	太空雷射 / Laser	<unknown>
spcewarl	太空雷射 / Space War (Leijac)	太空雷射 / Space War (Leijac)	Leijac (Konami)
m79amb	M79 伏擊	M79 伏擊	RamTek
alieninv	太空入侵者 / Alien Invasion Part II	太空入侵者 / Alien Invasion Part II	bootleg
tst_invd	太空入侵者 Test ROM	太空入侵者 Test ROM	Test ROM
sitv	太空入侵者 (TV Version)	太空入侵者 (TV Version)	Taito
sicv	太空入侵者 (CV Version)	太空入侵者 (CV Version)	Taito
sisv	太空入侵者 (SV Version)	太空入侵者 (SV Version)	Taito
sisv2	太空入侵者 (SV Version 2)	太空入侵者 (SV Version 2)	Taito
spacewr3	太空入侵者 / Space War Part 3	太空入侵者 / Space War Part 3	bootleg
invaderl	太空入侵者 (Logitec)	太空入侵者 (Logitec)	bootleg
invader4	太空入侵者 Part 4	太空入侵者 Part 4	bootleg
yosakdon	與作和東平 (set 1)	與作和東平 (set 1)	Wing
yosakdoa	與作和東平 (set 2)	與作和東平 (set 2)	Wing
spceking	太空入侵者 / 太空之王	太空入侵者 / 太空之王	Leijac (Konami)
spcewars	太空入侵者 / Space War (Sanritsu)	太空入侵者 / Space War (Sanritsu)	Sanritsu
seawolf2	海狼 II	海狼 II	Midway
twotiger	雙虎 (dedicated)	雙虎 (dedicated)	Bally Midway
twotigrc	雙虎 (Tron conversion)	雙虎 (Tron conversion)	Bally Midway
nflfoot	NFL 美式足球	NFL 美式足球	Bally Midway
spyhunt	間諜獵人	間諜獵人	Bally Midway
spyhunt2	間諜獵人 2 (rev 2)	間諜獵人 2 (rev 2)	Bally Midway
spyhnt2a	間諜獵人 2 (rev 1)	間諜獵人 2 (rev 1)	Bally Midway
sentetst	Sente 社診斷錄音盒	Sente 社診斷錄音盒	Bally/Sente
snakjack	頑皮傑克	頑皮傑克	Bally/Sente
minigolf	迷你高爾夫 (set 1)	迷你高爾夫 (set 1)	Bally/Sente
minigol2	迷你高爾夫 (set 2)	迷你高爾夫 (set 2)	Bally/Sente
greenber	綠色部隊 (Irem)	綠色部隊 (Irem)	Irem
redalert	紅色警戒	紅色警戒	Irem + GDI
mpatrol	砲彈飛車	砲彈飛車	Irem
mpatrolw	砲彈飛車 (Williams)	砲彈飛車 (Williams)	Irem (Williams license)
troangel	夏日天使	夏日天使	Irem
kungfum	成龍踢館 / 功夫大師	成龍踢館 / 功夫大師	Irem
kungfud	成龍踢館 / 功夫大師 (Data East)	成龍踢館 / 功夫大師 (Data East)	Irem (Data East license)
spartanx	成龍踢館 (日本版)	成龍踢館 (日本版)	Irem
kungfub	成龍踢館 / 功夫大師 (盜版 set 1)	成龍踢館 / 功夫大師 (盜版 set 1)	bootleg
kungfub2	成龍踢館 / 功夫大師 (盜版 set 2)	成龍踢館 / 功夫大師 (盜版 set 2)	bootleg
kidniki	快傑 Yancha 丸 / Kid Niki - Radical Ninja (世界版)	快傑 Yancha 丸 / Kid Niki - Radical Ninja (世界版)	Irem
kidnikiu	快傑 Yancha 丸 / Kid Niki - Radical Ninja (美國版)	快傑 Yancha 丸 / Kid Niki - Radical Ninja (美國版)	Irem (Data East USA license)
yanchamr	快傑 Yancha 丸 (日本版)	快傑 Yancha 丸 (日本版)	Irem
lithero	快傑 Yancha 丸 / Little Hero	快傑 Yancha 丸 / Little Hero	bootleg
spelunkr	洞穴探險	洞穴探險	Irem (licensed from Broderbund)
spelnkrj	洞穴探險 (日本版)	洞穴探險 (日本版)	Irem (licensed from Broderbund)
spelunk2	洞穴探險 II	洞穴探險 II	Irem (licensed from Broderbund)
youjyudn	妖獸傳 (日本版)	妖獸傳 (日本版)	Irem
vigilant	功夫小子 (世界版)	功夫小子 (世界版)	Irem
vigilntu	功夫小子 (美國版)	功夫小子 (美國版)	Irem (Data East USA license)
vigilntj	功夫小子 (日本版)	功夫小子 (日本版)	Irem
kikcubic	迷宮島 (日本版)	迷宮島 (日本版)	Irem
kikcubib	迷宮島 / Kickle Cubele	迷宮島 / Kickle Cubele	bootleg
rtype	異形戰機 / R-Type (日本版)	異形戰機 / R-Type (日本版)	Irem
rtypepj	異形戰機 / R-Type (日本版 開發版)	異形戰機 / R-Type (日本版 開發版)	Irem
rtypeu	異形戰機 / R-Type (美國版)	異形戰機 / R-Type (美國版)	Irem (Nintendo of America license)
bchopper	Mr. HELI 的大冒險 / Battle Chopper	Mr. HELI 的大冒險 / Battle Chopper	Irem
mrheli	Mr. HELI 的大冒險	Mr. HELI 的大冒險	Irem
nspirit	最後忍道 / Ninja Spirit	最後忍道 / Ninja Spirit	Irem
nspiritj	最後忍道 (日本版)	最後忍道 (日本版)	Irem
xmultipl	X 戰機 (日本版)	X 戰機 (日本版)	Irem
dbreed	神龍太子 (M81 pcb version)	神龍太子 (M81 pcb version)	Irem
dbreed72	神龍太子 (M72 pcb version)	神龍太子 (M72 pcb version)	Irem
rtype2	異形戰機 II / R-Type II	異形戰機 II / R-Type II	Irem
rtype2j	異形戰機 II / R-Type II (日本版)	異形戰機 II / R-Type II (日本版)	Irem
hharry	大力工頭 / Hammerin' Harry (世界版)	大力工頭 / Hammerin' Harry (世界版)	Irem
hharryu	大力工頭 / Hammerin' Harry (美國版)	大力工頭 / Hammerin' Harry (美國版)	Irem America
dkgensan	大力工頭 (日本版)	大力工頭 (日本版)	Irem
dkgenm72	大力工頭 (日本版, M72)	大力工頭 (日本版, M72)	Irem
airduel	未來戰機 (日本版)	未來戰機 (日本版)	Irem
cosmccop	雷馳 - 武裝警察 / Cosmic Cop (世界版)	雷馳 - 武裝警察 / Cosmic Cop (世界版)	Irem
gallop	雷馳 - 武裝警察 (日本版)	雷馳 - 武裝警察 (日本版)	Irem
kengo	劍豪	劍豪	Irem
sichuan2	四川省 - 女子寮篇 / Sichuan II (hack?) (set 1)	四川省 - 女子寮篇 / Sichuan II (hack?) (set 1)	Tamtex
sichuana	四川省 - 女子寮篇 / Sichuan II (hack?) (set 2)	四川省 - 女子寮篇 / Sichuan II (hack?) (set 2)	Tamtex
shisen	四川省 - 女子寮篇 (日本版)	四川省 - 女子寮篇 (日本版)	Tamtex
matchit	四川省 - 女子寮篇 / Match It	四川省 - 女子寮篇 / Match It	Tamtex
hasamu	霸沙夢 (日本版)	霸沙夢 (日本版)	Irem
bbmanw	炸彈超人 / New Dyna Blaster - Global Quest	炸彈超人 / New Dyna Blaster - Global Quest	Irem
bbmanwj	炸彈超人 (日本版)	炸彈超人 (日本版)	Irem
bomblord	炸彈超人 / Bomber Lord (盜版)	炸彈超人 / Bomber Lord (盜版)	bootleg
newapunk	炸彈超人 / New Atomic Punk - Global Quest (美國版)	炸彈超人 / New Atomic Punk - Global Quest (美國版)	Irem America
matchit2	四川省 II / Match It II	四川省 II / Match It II	Tamtex
shisen2	四川省 II	四川省 II	Tamtex
gunforce	戰火驚魂 (世界版)	戰火驚魂 (世界版)	Irem
gunforcu	戰火驚魂 (美國版)	戰火驚魂 (美國版)	Irem America
gunforcj	戰火驚魂 (日本版)	戰火驚魂 (日本版)	Irem
bmaster	刀鋒領主 (世界版)	刀鋒領主 (世界版)	Irem
lethalth	致命因子 / Lethal Thunder (世界版)	致命因子 / Lethal Thunder (世界版)	Irem
thndblst	致命因子 (日本版)	致命因子 (日本版)	Irem
uccops	暴力刑警 (世界版)	暴力刑警 (世界版)	Irem
uccopsj	暴力刑警 (日本版)	暴力刑警 (日本版)	Irem
mysticri	魔法警備隊 / Mystic Riders (世界版)	魔法警備隊 / Mystic Riders (世界版)	Irem
gunhohki	魔法警備隊 (日本版)	魔法警備隊 (日本版)	Irem
hook	虎克船長 (世界版)	虎克船長 (世界版)	Irem
hooku	虎克船長 (美國版)	虎克船長 (美國版)	Irem America
hookj	虎克船長 (日本版)	虎克船長 (日本版)	Irem
rtypeleo	異形戰機 LEO / R-Type Leo (世界版)	異形戰機 LEO / R-Type Leo (世界版)	Irem
rtypelej	異形戰機 LEO / R-Type Leo (日本版)	異形戰機 LEO / R-Type Leo (日本版)	Irem
inthunt	海底大戰爭 / In The Hunt (世界版) 	海底大戰爭 / In The Hunt (世界版) 	Irem
inthuntu	海底大戰爭 / In The Hunt (美國版)	海底大戰爭 / In The Hunt (美國版)	Irem America
kaiteids	海底大戰爭 (日本版)	海底大戰爭 (日本版)	Irem
nbbatman	棒球殺手 / Ninja Baseball Batman (美國版)	棒球殺手 / Ninja Baseball Batman (美國版)	Irem America
leaguemn	棒球殺手 (日本版)	棒球殺手 (日本版)	Irem
ssoldier	完美戰士 / Superior Soldiers (美國版)	完美戰士 / Superior Soldiers (美國版)	Irem America
psoldier	完美戰士 (日本版)	完美戰士 (日本版)	Irem
dsccr94j	夢幻足球 '94 (日本版)	夢幻足球 '94 (日本版)	Irem
gunforc2	戰火驚魂 2 (美國版)	戰火驚魂 2 (美國版)	Irem
geostorm	戰火驚魂 2 / Geostorm (日本版)	戰火驚魂 2 / Geostorm (日本版)	Irem
firebarr	火爆戰機 (日本版)	火爆戰機 (日本版)	Irem
dsoccr94	夢幻足球 '94	夢幻足球 '94	Irem (Data East Corporation license)
wpksoc	世界 PK 足球	世界 PK 足球	Jaleco
mplanets	瘋狂星球	瘋狂星球	Gottlieb
mplanuk	瘋狂星球 (英國版)	瘋狂星球 (英國版)	Gottlieb (Taitel license)
krull	銀河傳說	銀河傳說	Gottlieb
qbertqub	Q*bert 的方塊	Q*bert 的方塊	Mylstar
junglek	森林王子 (日本版)	森林王子 (日本版)	Taito Corporation
junglkj2	森林王子 (日本版, 早期版)	森林王子 (日本版, 早期版)	Taito Corporation
jungleh	森林王子 / Jungle Hunt (美國版)	森林王子 / Jungle Hunt (美國版)	Taito America Corporation
junglhbr	森林王子 / Jungle Hunt (巴西版)	森林王子 / Jungle Hunt (巴西版)	Taito do Brasil
piratpet	森林王子 / Pirate Pete	森林王子 / Pirate Pete	Taito America Corporation
alpine	高山滑雪 (set 1)	高山滑雪 (set 1)	Taito Corporation
alpinea	高山滑雪 (set 2)	高山滑雪 (set 2)	Taito Corporation
timetunl	時光隧道	時光隧道	Taito Corporation
wwestern	狂野西部 (set 1)	狂野西部 (set 1)	Taito Corporation
wwester1	狂野西部 (set 2)	狂野西部 (set 2)	Taito Corporation
frontlin	前線	前線	Taito Corporation
elevator	電梯大戰	電梯大戰	Taito Corporation
elevatob	電梯大戰 (盜版)	電梯大戰 (盜版)	bootleg
bioatack	生化攻擊	生化攻擊	Taito Corporation (Fox Video Games license)
sfposeid	海神戰士	海神戰士	Taito Corporation
crbaloon	瘋狂氣球 (set 1)	瘋狂氣球 (set 1)	Taito Corporation
crbalon2	瘋狂氣球 (set 2)	瘋狂氣球 (set 2)	Taito Corporation
gsword	西洋劍 (世界版?)	西洋劍 (世界版?)	Taito Corporation
gsword2	西洋劍 (日本版?)	西洋劍 (日本版?)	Taito Corporation
lkage	影子傳說	影子傳說	Taito Corporation
lkageb	影子傳說 (盜版 set 1)	影子傳說 (盜版 set 1)	bootleg
lkageb2	影子傳說 (盜版 set 2)	影子傳說 (盜版 set 2)	bootleg
lkageb3	影子傳說 (盜版 set 3)	影子傳說 (盜版 set 3)	bootleg
retofinv	侵略者回歸	侵略者回歸	Taito Corporation
retofin1	侵略者回歸 (盜版 set 1)	侵略者回歸 (盜版 set 1)	bootleg
retofin2	侵略者回歸 (盜版 set 2)	侵略者回歸 (盜版 set 2)	bootleg
fightrol	滾軸王牌 / Fighting Roller	滾軸王牌 / Fighting Roller	[Kaneko] (Taito license)
rollace	滾軸王牌 / Roller Aces (set 1)	滾軸王牌 / Roller Aces (set 1)	[Kaneko] (Williams license)
rollace2	滾軸王牌 / Roller Aces (set 2)	滾軸王牌 / Roller Aces (set 2)	[Kaneko] (Williams license)
tsamurai	侍 日本一 (set 1)	侍 日本一 (set 1)	Taito
tsamura2	侍 日本一 (set 2)	侍 日本一 (set 2)	Taito
nunchaku	功夫少女	功夫少女	Taito
yamagchi	決死的探險! 山口君	決死的探險! 山口君	Taito
m660	660 任務 (美國版)	660 任務 (美國版)	[Woodplace Inc.] Taito America Corporation
m660j	660 任務 (日本版)	660 任務 (日本版)	[Woodplace Inc.] Taito Corporation
m660b	660 任務 (盜版)	660 任務 (盜版)	bootleg
alphaxz	660 任務 / The Alphax Z (日本版)	660 任務 / The Alphax Z (日本版)	Ed / Woodplace Inc.
flstory	仙境物語	仙境物語	Taito
flstoryj	仙境物語 (日本版)	仙境物語 (日本版)	Taito
onna34ro	女三四郎 (set 1)	女三四郎 (set 1)	Taito
onna34ra	女三四郎 (set 2)	女三四郎 (set 2)	Taito
gladiatr	黃金城 / Gladiator (美國版)	黃金城 / Gladiator (美國版)	Taito America Corporation
ogonsiro	黃金城 (日本版)	黃金城 (日本版)	Taito Corporation
greatgur	黃金城 / Great Gurianos (日本版?)	黃金城 / Great Gurianos (日本版?)	Taito Corporation
ksayakyu	草野球	草野球	Taito Corporation
lsasquad	陸海空 - 最前線 / Land Sea Air Squad	陸海空 - 最前線 / Land Sea Air Squad	Taito
storming	陸海空 - 最前線 / Storming Party	陸海空 - 最前線 / Storming Party	Taito
daikaiju	大怪獸的逆襲	大怪獸的逆襲	Taito
tokio	轟炸東京	轟炸東京	Taito Corporation
tokiou	轟炸東京 (美國版)	轟炸東京 (美國版)	Taito America Corporation (Romstar license)
tokiob	轟炸東京 (盜版)	轟炸東京 (盜版)	bootleg
bublbobl	泡泡龍	泡泡龍	Taito Corporation
bublbob1	泡泡龍 (舊)	泡泡龍 (舊)	Taito Corporation
bublbobr	泡泡龍 (美國版 with mode select)	泡泡龍 (美國版 with mode select)	Taito America Corporation (Romstar license)
bubbobr1	泡泡龍 (美國版)	泡泡龍 (美國版)	Taito America Corporation (Romstar license)
boblbobl	泡泡龍 / Bobble Bobble	泡泡龍 / Bobble Bobble	bootleg
sboblbob	泡泡龍 / Super Bobble Bobble	泡泡龍 / Super Bobble Bobble	bootleg
missb2	泡泡龍 / Miss Bubble 2	泡泡龍 / Miss Bubble 2	Alpha Co
kikikai	奇奇怪界	奇奇怪界	Taito Corporation
knightb	奇奇怪界 / Knight Boy	奇奇怪界 / Knight Boy	bootleg
darius	太空戰鬥機 (世界版)	太空戰鬥機 (世界版)	Taito Corporation Japan
dariusj	太空戰鬥機 (日本版)	太空戰鬥機 (日本版)	Taito Corporation
dariuso	太空戰鬥機 (日本版 舊版)	太空戰鬥機 (日本版 舊版)	Taito Corporation
dariuse	太空戰鬥機 (Extra) (日本版)	太空戰鬥機 (Extra) (日本版)	Taito Corporation
topspeed	全速進攻 / Top Speed (世界版)	全速進攻 / Top Speed (世界版)	Taito Corporation Japan
topspedu	全速進攻 / Top Speed (美國版)	全速進攻 / Top Speed (美國版)	Taito America Corporation (Romstar license)
fullthrl	全速進攻 (日本版)	全速進攻 (日本版)	Taito Corporation
opwolf	烏茲衝鋒槍 (世界版)	烏茲衝鋒槍 (世界版)	Taito Corporation Japan
opwolfu	烏茲衝鋒槍 (美國版)	烏茲衝鋒槍 (美國版)	Taito America Corporation
opwolfb	烏茲衝鋒槍 / Operation Bear	烏茲衝鋒槍 / Operation Bear	bootleg
othunder	烏茲衝鋒槍二 (世界版)	烏茲衝鋒槍二 (世界版)	Taito Corporation Japan
othundu	烏茲衝鋒槍二 (美國版)	烏茲衝鋒槍二 (美國版)	Taito America Corporation
othunduo	烏茲衝鋒槍二 (美國版, 舊版)	烏茲衝鋒槍二 (美國版, 舊版)	Taito America Corporation
othundrj	烏茲衝鋒槍二 (日本版)	烏茲衝鋒槍二 (日本版)	Taito Corporation
rainbow	彩虹島 (新版)	彩虹島 (新版)	Taito Corporation
rainbowo	彩虹島 (舊版)	彩虹島 (舊版)	Taito Corporation
rainbowe	彩虹島 (Extra)	彩虹島 (Extra)	Taito Corporation
jumping	彩虹島 / Jumping	彩虹島 / Jumping	bootleg
arkanoid	打磚塊 (世界版)	打磚塊 (世界版)	Taito Corporation Japan
arknoidu	打磚塊 (美國版)	打磚塊 (美國版)	Taito America Corporation (Romstar license)
arknoiuo	打磚塊 (美國版, 舊版)	打磚塊 (美國版, 舊版)	Taito America Corporation (Romstar license)
arknoidj	打磚塊 (日本版)	打磚塊 (日本版)	Taito Corporation
arkbl2	打磚塊 (日文 盜版 Set 2)	打磚塊 (日文 盜版 Set 2)	bootleg
arkbl3	打磚塊 (日文 盜版 Set 3)	打磚塊 (日文 盜版 Set 3)	bootleg
paddle2	打磚塊 / Paddle 2	打磚塊 / Paddle 2	bootleg
arkatayt	打磚塊 (Tayto 盜版, 日文)	打磚塊 (Tayto 盜版, 日文)	bootleg
arkblock	打磚塊 / Block (盜版, 日文)	打磚塊 / Block (盜版, 日文)	bootleg
arkbloc2	打磚塊 / Block (Game Corporation 盜版)	打磚塊 / Block (Game Corporation 盜版)	bootleg
arkangc	打磚塊 (Game Corporation 盜版)	打磚塊 (Game Corporation 盜版)	bootleg
arkatour	打磚塊 / Tournament Arkanoid (美國版)	打磚塊 / Tournament Arkanoid (美國版)	Taito America Corporation (Romstar license)
tetrsark	俄羅斯方塊 (D.R. 韓國版)	俄羅斯方塊 (D.R. 韓國版)	D.R. Korea
minivadr	迷你小蜜蜂	迷你小蜜蜂	Taito Corporation
bonzeadv	地獄冒險 / Bonze Adventure (世界版, 新版)	地獄冒險 / Bonze Adventure (世界版, 新版)	Taito Corporation Japan
bonzeado	地獄冒險 / Bonze Adventure (世界版, 舊版)	地獄冒險 / Bonze Adventure (世界版, 舊版)	Taito Corporation Japan
bonzeadu	地獄冒險 / Bonze Adventure (美國版)	地獄冒險 / Bonze Adventure (美國版)	Taito America Corporation
jigkmgri	地獄冒險 (日本版)	地獄冒險 (日本版)	Taito Corporation
asuka	飛鳥 & 飛鳥 (日本版)	飛鳥 & 飛鳥 (日本版)	Taito Corporation
earthjkr	國聯防衛軍: 地球王牌 (日本版)	國聯防衛軍: 地球王牌 (日本版)	Visco
eto	古今東西干支物語 (日本版)	古今東西干支物語 (日本版)	Visco
wgp	國際機車大獎賽 (美國版)	國際機車大獎賽 (美國版)	Taito America Corporation
wgpj	國際機車大獎賽 (日本版)	國際機車大獎賽 (日本版)	Taito Corporation
wgpjoy	國際機車大獎賽 (搖桿版 set 1) (日本版)	國際機車大獎賽 (搖桿版 set 1) (日本版)	Taito Corporation
wgpjoya	國際機車大獎賽 (搖桿版 set 2) (日本版)	國際機車大獎賽 (搖桿版 set 2) (日本版)	Taito Corporation
wgp2	國際機車大獎賽 2 (日本版)	國際機車大獎賽 2 (日本版)	Taito Corporation
opwolf3	烏茲衝鋒槍 3 (世界版)	烏茲衝鋒槍 3 (世界版)	Taito Corporation Japan
opwolf3u	烏茲衝鋒槍 3 (美國版)	烏茲衝鋒槍 3 (美國版)	Taito America Corporation
ninjaw	忍者武士 (世界版)	忍者武士 (世界版)	Taito Corporation Japan
ninjawj	忍者武士 (日本版)	忍者武士 (日本版)	Taito Corporation
darius2	太空戰鬥機 II (日本版)	太空戰鬥機 II (日本版)	Taito Corporation
darius2d	太空戰鬥機 II (雙螢幕) (日本版)	太空戰鬥機 II (雙螢幕) (日本版)	Taito Corporation
drius2do	太空戰鬥機 II (雙螢幕) (日本版 舊版)	太空戰鬥機 II (雙螢幕) (日本版 舊版)	Taito Corporation
warriorb	武士之刃 (日本版)	武士之刃 (日本版)	Taito Corporation
superman	超人	超人	Taito Corporation
suprmanj	超人 (日本版)	超人 (日本版)	Taito Corporation
twinhawk	大旋風 / Twin Hawk (世界版)	大旋風 / Twin Hawk (世界版)	Taito Corporation Japan
twinhwku	大旋風 / Twin Hawk (美國版)	大旋風 / Twin Hawk (美國版)	Taito America Corporation
daisenpu	大旋風 (日本版)	大旋風 (日本版)	Taito Corporation
arknoid2	打磚塊二 / 打磚塊 - DOH 的復仇 (世界版)	打磚塊二 / 打磚塊 - DOH 的復仇 (世界版)	Taito Corporation Japan
arknid2u	打磚塊二 / 打磚塊 - DOH 的復仇 (美國版)	打磚塊二 / 打磚塊 - DOH 的復仇 (美國版)	Taito America Corporation (Romstar license)
arknid2j	打磚塊二 / 打磚塊 - DOH 的復仇 (日本版)	打磚塊二 / 打磚塊 - DOH 的復仇 (日本版)	Taito Corporation
drtoppel	Toppel 博士探險隊 / Dr. Toppel's Adventure (世界版)	Toppel 博士探險隊 / Dr. Toppel's Adventure (世界版)	Taito Corporation Japan
drtopplu	Toppel 博士探險隊 / Dr. Toppel's Adventure (美國版)	Toppel 博士探險隊 / Dr. Toppel's Adventure (美國版)	Taito America Corporation
drtopplj	Toppel 博士探險隊 (日本版)	Toppel 博士探險隊 (日本版)	Taito Corporation
kageki	火激 (美國版)	火激 (美國版)	Taito America Corporation (Romstar license)
kagekij	火激 (日本版)	火激 (日本版)	Taito Corporation
kagekia	火激 (世界版?, hack)	火激 (世界版?, hack)	Taito Corporation
chukatai	中華大仙 (世界版)	中華大仙 (世界版)	Taito Corporation Japan
chukatau	中華大仙 (美國版)	中華大仙 (美國版)	Taito America Corporation
chukataj	中華大仙 (日本版)	中華大仙 (日本版)	Taito Corporation
kabukiz	歌舞伎-Z (世界版)	歌舞伎-Z (世界版)	Taito Corporation Japan
kabukizj	歌舞伎-Z (日本版)	歌舞伎-Z (日本版)	Taito Corporation
kurikint	功里金團 (世界版)	功里金團 (世界版)	Taito Corporation Japan
kurikinu	功里金團 (美國版)	功里金團 (美國版)	Taito America Corporation
kurikinj	功里金團 (日本版)	功里金團 (日本版)	Taito Corporation
kurikina	功里金團 (世界版, 開發版?)	功里金團 (世界版, 開發版?)	Taito Corporation Japan
fhawk	戰鬥獵鷹 (世界版)	戰鬥獵鷹 (世界版)	Taito Corporation Japan
fhawkj	戰鬥獵鷹 (日本版)	戰鬥獵鷹 (日本版)	Taito Corporation
champwr	冠軍摔跤 (世界版)	冠軍摔跤 (世界版)	Taito Corporation Japan
champwru	冠軍摔跤 (美國版)	冠軍摔跤 (美國版)	Taito America Corporation
champwrj	冠軍摔跤 (日本版)	冠軍摔跤 (日本版)	Taito Corporation
dleague	火爆聯盟 (日本版)	火爆聯盟 (日本版)	Taito Corporation
rambo3	藍波 III (歐洲版 set 1)	藍波 III (歐洲版 set 1)	Taito Europe Corporation
rambo3ae	藍波 III (歐洲版 set 2)	藍波 III (歐洲版 set 2)	Taito Europe Corporation
rambo3a	藍波 III (美國版)	藍波 III (美國版)	Taito America Corporation
crimec	罪惡都市 (世界版)	罪惡都市 (世界版)	Taito Corporation Japan
crimecu	罪惡都市 (美國版)	罪惡都市 (美國版)	Taito America Corporation
crimecj	罪惡都市 (日本版)	罪惡都市 (日本版)	Taito Corporation
tetrist	俄羅斯方塊 (日本版, B-System, YM2610)	俄羅斯方塊 (日本版, B-System, YM2610)	Sega
tetrista	俄羅斯方塊 (日本版, B-System, YM2203)	俄羅斯方塊 (日本版, B-System, YM2203)	Sega
viofight	暴力格鬥 (世界版)	暴力格鬥 (世界版)	Taito Corporation Japan
viofighu	暴力格鬥 (美國版)	暴力格鬥 (美國版)	Taito America Corporation
ashura	阿修羅風暴 (日本版)	阿修羅風暴 (日本版)	Taito Corporation
ashurau	阿修羅風暴 (美國版)	阿修羅風暴 (美國版)	Taito America Corporation
sbm	超級拳王 (日本版)	超級拳王 (日本版)	Taito Corporation
silentd	沉默之龍 (世界版)	沉默之龍 (世界版)	Taito Corporation Japan
silentdj	沉默之龍 (日本版)	沉默之龍 (日本版)	Taito Corporation
ryujin	龍神 (日本版)	龍神 (日本版)	Taito Corporation
qzshowby	問答世界 (日本版)	問答世界 (日本版)	Taito Corporation
pbobble	泡泡龍解謎 (日本版, B-System)	泡泡龍解謎 (日本版, B-System)	Taito Corporation
spacedx	太空入侵者 DX (美國版) v2.1	太空入侵者 DX (美國版) v2.1	Taito Corporation
spacedxj	太空入侵者 DX (日本版) v2.1	太空入侵者 DX (日本版) v2.1	Taito Corporation
spacedxo	太空入侵者 DX (日本版) v2.0	太空入侵者 DX (日本版) v2.0	Taito Corporation
chasehq	追蹤 H.Q. (世界版)	追蹤 H.Q. (世界版)	Taito Corporation Japan
chasehqj	追蹤 H.Q. (日本版)	追蹤 H.Q. (日本版)	Taito Corporation
nightstr	午夜出擊 (美國版)	午夜出擊 (美國版)	Taito America Corporation
sci	S.C.I. 特別刑事調查組 (世界版 set 1)	S.C.I. 特別刑事調查組 (世界版 set 1)	Taito Corporation Japan
scia	S.C.I. 特別刑事調查組 (世界版 set 2)	S.C.I. 特別刑事調查組 (世界版 set 2)	Taito Corporation Japan
sciu	S.C.I. 特別刑事調查組 (美國版)	S.C.I. 特別刑事調查組 (美國版)	Taito America Corporation
bshark	獵鯊行動 (美國版)	獵鯊行動 (美國版)	Taito America Corporation
bsharkj	獵鯊行動 (日本版)	獵鯊行動 (日本版)	Taito Corporation
dblaxle	四驅賽車 / Double Axle (美國版)	四驅賽車 / Double Axle (美國版)	Taito America Corporation
pwheelsj	四驅賽車 (日本版)	四驅賽車 (日本版)	Taito Corporation
superchs	超級追蹤 - 罪惡終結者 (美國版)	超級追蹤 - 罪惡終結者 (美國版)	Taito America Corporation
finalb	最終打擊 (世界版)	最終打擊 (世界版)	Taito Corporation Japan
finalbj	最終打擊 (日本版)	最終打擊 (日本版)	Taito Corporation
finalbu	最終打擊 (美國版)	最終打擊 (美國版)	Taito America Corporation
thundfox	雷狐戰士 (世界版)	雷狐戰士 (世界版)	Taito Corporation Japan
thndfoxu	雷狐戰士 (美國版)	雷狐戰士 (美國版)	Taito America Corporation
thndfoxj	雷狐戰士 (日本版)	雷狐戰士 (日本版)	Taito Corporation
qtorimon	苦胃頭捕物帳 (日本版)	苦胃頭捕物帳 (日本版)	Taito Corporation
liquidk	泡泡小子 (世界版)	泡泡小子 (世界版)	Taito Corporation Japan
liquidku	泡泡小子 (美國版)	泡泡小子 (美國版)	Taito America Corporation
mizubaku	泡泡小子 / Mizubaku Daibouken (日本版)	泡泡小子 / Mizubaku Daibouken (日本版)	Taito Corporation
quizhq	問答大本營 (日本版)	問答大本營 (日本版)	Taito Corporation
ssi	太空入侵者 Part IV / 超級太空入侵者 '91 (世界版)	太空入侵者 Part IV / 超級太空入侵者 '91 (世界版)	Taito Corporation Japan
majest12	太空入侵者 Part IV (日本版)	太空入侵者 Part IV (日本版)	Taito Corporation
gunfront	槍之國度 / Gun & Frontier (世界版)	槍之國度 / Gun & Frontier (世界版)	Taito Corporation Japan
gunfronj	槍之國度 (日本版)	槍之國度 (日本版)	Taito Corporation
growl	森林守護神 / Growl (世界版)	森林守護神 / Growl (世界版)	Taito Corporation Japan
growlu	森林守護神 / Growl (美國版)	森林守護神 / Growl (美國版)	Taito America Corporation
runark	森林守護神 / Runark (日本版)	森林守護神 / Runark (日本版)	Taito Corporation
mjnquest	麻雀探險 (日本版)	麻雀探險 (日本版)	Taito Corporation
mjnquesb	麻雀探險 (No Nudity)	麻雀探險 (No Nudity)	Taito Corporation
koshien	嗚呼榮光甲子園 (日本版)	嗚呼榮光甲子園 (日本版)	Taito Corporation
ninjak	忍者小子 (世界版)	忍者小子 (世界版)	Taito Corporation Japan
ninjakj	忍者小子 (日本版)	忍者小子 (日本版)	Taito Corporation
ninjaku	忍者小子 (美國版)	忍者小子 (美國版)	Taito America Corporation
qzquest	問答搜查 - 公主與勇者物語 (日本版)	問答搜查 - 公主與勇者物語 (日本版)	Taito Corporation
qzchikyu	問答地球防衛軍 (日本版)	問答地球防衛軍 (日本版)	Taito Corporation
deadconx	死亡邊緣 (世界版)	死亡邊緣 (世界版)	Taito Corporation Japan
deadconj	死亡邊緣 (日本版)	死亡邊緣 (日本版)	Taito Corporation
dinorex	大恐龍格鬥技傳說 (世界版)	大恐龍格鬥技傳說 (世界版)	Taito Corporation Japan
dinorexj	大恐龍格鬥技傳說 (日本版)	大恐龍格鬥技傳說 (日本版)	Taito Corporation
dinorexu	大恐龍格鬥技傳說 (美國版)	大恐龍格鬥技傳說 (美國版)	Taito America Corporation
qjinsei	問答人生劇場 (日本版)	問答人生劇場 (日本版)	Taito Corporation
qcrayon	問答蠟筆小新 (日本版)	問答蠟筆小新 (日本版)	Taito Corporation
qcrayon2	蠟筆小新 (日本版)	蠟筆小新 (日本版)	Taito Corporation
arabianm	阿拉伯魔法 (Ver 1.0O 1992/07/06)	阿拉伯魔法 (Ver 1.0O 1992/07/06)	Taito Corporation Japan
arabiamj	阿拉伯魔法 (Ver 1.0J 1992/07/06)	阿拉伯魔法 (Ver 1.0J 1992/07/06)	Taito Corporation
arabiamu	阿拉伯魔法 (Ver 1.0A 1992/07/06)	阿拉伯魔法 (Ver 1.0A 1992/07/06)	Taito America Corporation
kaiserkn	王者鐵拳 (Ver 2.1O 1994/07/29)	王者鐵拳 (Ver 2.1O 1994/07/29)	Taito Corporation Japan
kaiserkj	王者鐵拳 (Ver 2.1J 1994/07/29)	王者鐵拳 (Ver 2.1J 1994/07/29)	Taito Corporation
gblchmp	王者鐵拳 / Global Champion (Ver 2.1A 1994/07/29)	王者鐵拳 / Global Champion (Ver 2.1A 1994/07/29)	Taito America Corporation
dankuga	斷仇牙 (ver 0.0J 1994/12/13) (開發版)	斷仇牙 (ver 0.0J 1994/12/13) (開發版)	Taito Corporation
dariusg	太空戰鬥機外傳 - 銀鷹 (Ver 2.5O 1994/09/19)	太空戰鬥機外傳 - 銀鷹 (Ver 2.5O 1994/09/19)	Taito Corporation Japan
dariusgj	太空戰鬥機外傳 - 銀鷹 (Ver 2.5J 1994/09/19)	太空戰鬥機外傳 - 銀鷹 (Ver 2.5J 1994/09/19)	Taito Corporation
dariusgu	太空戰鬥機外傳 - 銀鷹 (Ver 2.5A 1994/09/19)	太空戰鬥機外傳 - 銀鷹 (Ver 2.5A 1994/09/19)	Taito America Corporation
dariusgx	太空戰鬥機外傳 - 銀鷹 Extra Version (Ver 2.7J 1995/03/06) (Official Hack)	太空戰鬥機外傳 - 銀鷹 Extra Version (Ver 2.7J 1995/03/06) (Official Hack)	Taito Corporation
bublbob2	泡泡龍 II (Ver 2.5O 1994/10/05)	泡泡龍 II (Ver 2.5O 1994/10/05)	Taito Corporation Japan
bubsympe	泡泡龍 2 / Bubble Symphony (Ver 2.5O 1994/10/05)	泡泡龍 2 / Bubble Symphony (Ver 2.5O 1994/10/05)	Taito Corporation Japan
bubsympu	泡泡龍 2 / Bubble Symphony (Ver 2.5A 1994/10/05)	泡泡龍 2 / Bubble Symphony (Ver 2.5A 1994/10/05)	Taito America Corporation
bubsymph	泡泡龍 2 / Bubble Symphony (Ver 2.5J 1994/10/05)	泡泡龍 2 / Bubble Symphony (Ver 2.5J 1994/10/05)	Taito Corporation
spcinvdj	太空入侵者 DX (Ver 2.6J 1994/09/14) (F3 Version)	太空入侵者 DX (Ver 2.6J 1994/09/14) (F3 Version)	Taito Corporation
qtheater	問答劇場 - 第 3 物語 (Ver 2.3J 1994/11/10)	問答劇場 - 第 3 物語 (Ver 2.3J 1994/11/10)	Taito Corporation
elvactr	電梯大戰 2 / Elevator Action Returns (Ver 2.2O 1995/02/20)	電梯大戰 2 / Elevator Action Returns (Ver 2.2O 1995/02/20)	Taito Corporation Japan
elvactrj	電梯大戰 2 / Elevator Action Returns (Ver 2.2J 1995/02/20)	電梯大戰 2 / Elevator Action Returns (Ver 2.2J 1995/02/20)	Taito Corporation
elvact2u	電梯大戰 2 (Ver 2.2A 1995/02/20)	電梯大戰 2 (Ver 2.2A 1995/02/20)	Taito America Corporation
spcinv95	太空入侵者 '95 - 瘋狂月球攻擊 (Ver 2.5O 1995/06/14)	太空入侵者 '95 - 瘋狂月球攻擊 (Ver 2.5O 1995/06/14)	Taito Corporation Japan
spcnv95u	太空入侵者 '95 - 瘋狂月球攻擊 (Ver 2.5A 1995/06/14)	太空入侵者 '95 - 瘋狂月球攻擊 (Ver 2.5A 1995/06/14)	Taito America Corporation
akkanvdr	太空入侵者 '95 - 瘋狂月球攻擊 / Akkanvader (Ver 2.5J 1995/06/14)	太空入侵者 '95 - 瘋狂月球攻擊 / Akkanvader (Ver 2.5J 1995/06/14)	Taito Corporation
quizhuhu	森口博子問答 (Ver 2.2J 1995/05/25)	森口博子問答 (Ver 2.2J 1995/05/25)	Taito Corporation
pbobble2	泡泡龍解謎 2 (Ver 2.2O 1995/07/20)	泡泡龍解謎 2 (Ver 2.2O 1995/07/20)	Taito Corporation Japan
pbobbl2j	泡泡龍解謎 2 (Ver 2.2J 1995/07/20)	泡泡龍解謎 2 (Ver 2.2J 1995/07/20)	Taito Corporation
pbobbl2u	泡泡龍解謎 2 / Bust-A-Move Again (Ver 2.3A 1995/07/31)	泡泡龍解謎 2 / Bust-A-Move Again (Ver 2.3A 1995/07/31)	Taito America Corporation
pbobbl2x	泡泡龍解謎 2X (Ver 2.2J 1995/11/11)	泡泡龍解謎 2X (Ver 2.2J 1995/11/11)	Taito Corporation
gekirido	逆鱗彈 (Ver 2.3J 1995/09/21)	逆鱗彈 (Ver 2.3J 1995/09/21)	Taito Corporation
tcobra2	究極虎 2 / Twin Cobra 2 (Ver 2.1O 1995/11/30)	究極虎 2 / Twin Cobra 2 (Ver 2.1O 1995/11/30)	Taito Corporation Japan
tcobra2u	究極虎 2 / Twin Cobra 2 (Ver 2.1A 1995/11/30)	究極虎 2 / Twin Cobra 2 (Ver 2.1A 1995/11/30)	Taito America Corporation
ktiger2	究極虎 2 (Ver 2.1J 1995/11/30)	究極虎 2 (Ver 2.1J 1995/11/30)	Taito Corporation
bubblem	泡泡龍 3 (Ver 2.4O 1996/02/15)	泡泡龍 3 (Ver 2.4O 1996/02/15)	Taito Corporation Japan
bubblemj	泡泡龍 3 (Ver 2.3J 1996/02/07)	泡泡龍 3 (Ver 2.3J 1996/02/07)	Taito Corporation
pbobble3	泡泡龍解謎 3 (Ver 2.1O 1996/09/27)	泡泡龍解謎 3 (Ver 2.1O 1996/09/27)	Taito Corporation
pbobbl3u	泡泡龍解謎 3 (Ver 2.1A 1996/09/27)	泡泡龍解謎 3 (Ver 2.1A 1996/09/27)	Taito Corporation
pbobbl3j	泡泡龍解謎 3 (Ver 2.1J 1996/09/27)	泡泡龍解謎 3 (Ver 2.1J 1996/09/27)	Taito Corporation
arkretrn	打磚塊三 / 打磚塊回歸 (Ver 2.02J 1997/02/10)	打磚塊三 / 打磚塊回歸 (Ver 2.02J 1997/02/10)	Taito Corporation
pbobble4	泡泡龍解謎 4 (Ver 2.04O 1997/12/19)	泡泡龍解謎 4 (Ver 2.04O 1997/12/19)	Taito Corporation
pbobbl4j	泡泡龍解謎 4 (Ver 2.04J 1997/12/19)	泡泡龍解謎 4 (Ver 2.04J 1997/12/19)	Taito Corporation
pbobbl4u	泡泡龍解謎 4 (Ver 2.04A 1997/12/19)	泡泡龍解謎 4 (Ver 2.04A 1997/12/19)	Taito Corporation
dendeg	電車 GO!	電車 GO!	Taito
dendegx	電車 GO! EX	電車 GO! EX	Taito
dendeg2	電車 GO! 2 - 高速篇	電車 GO! 2 - 高速篇	Taito
dendeg2x	電車 GO! 2 EX - 高速篇 3000 番台	電車 GO! 2 EX - 高速篇 3000 番台	Taito
pf2012	超能力大戰 2012	超能力大戰 2012	Taito
mjsister	麻雀姊妹 (日本版)	麻雀姊妹 (日本版)	Toaplan
fshark	飛翔鮫 / Flying Shark (世界版)	飛翔鮫 / Flying Shark (世界版)	[Toaplan] Taito Corporation
skyshark	飛翔鮫 / Sky Shark (美國版)	飛翔鮫 / Sky Shark (美國版)	[Toaplan] Taito America Corporation (Romstar license)
hishouza	飛翔鮫 (日本版)	飛翔鮫 (日本版)	[Toaplan] Taito Corporation
fsharkbt	飛翔鮫 / Flying Shark (盜版)	飛翔鮫 / Flying Shark (盜版)	bootleg
twincobr	究極虎 / Twin Cobra (世界版)	究極虎 / Twin Cobra (世界版)	[Toaplan] Taito Corporation
twincobu	究極虎 / Twin Cobra (美國版)	究極虎 / Twin Cobra (美國版)	[Toaplan] Taito America Corporation (Romstar license)
ktiger	究極虎 (日本版)	究極虎 (日本版)	[Toaplan] Taito Corporation
rallybik	衝刺野郎	衝刺野郎	[Toaplan] Taito Corporation
truxton	達人	達人	[Toaplan] Taito Corporation
hellfire	地獄火	地獄火	Toaplan (Taito license)
hellfir1	地獄火 (1P Ver.)	地獄火 (1P Ver.)	Toaplan (Taito license)
zerowing	零式戰機	零式戰機	Toaplan
fireshrk	鮫! 鮫! 鮫! / Fire Shark	鮫! 鮫! 鮫! / Fire Shark	Toaplan
samesame	鮫! 鮫! 鮫!	鮫! 鮫! 鮫!	Toaplan
samesam2	鮫! 鮫! 鮫! (2P Ver.)	鮫! 鮫! 鮫! (2P Ver.)	Toaplan
outzone	異域戰將 (set 1)	異域戰將 (set 1)	Toaplan
outzonea	異域戰將 (set 2)	異域戰將 (set 2)	Toaplan
outzoneb	異域戰將 (set 3, 開發版?)	異域戰將 (set 3, 開發版?)	Toaplan
outzonec	異域戰將 (set 4)	異域戰將 (set 4)	Toaplan
vimana	銀河戰機	銀河戰機	Toaplan
vimana1	銀河戰機 (舊 set)	銀河戰機 (舊 set)	Toaplan
vimanan	銀河戰機 (Nova Apparate GMBH & Co)	銀河戰機 (Nova Apparate GMBH & Co)	Toaplan (Nova Apparate GMBH & Co license)
snowbros	雪人兄弟 - 尼克和湯姆 (set 1)	雪人兄弟 - 尼克和湯姆 (set 1)	Toaplan
snowbroa	雪人兄弟 - 尼克和湯姆 (set 2)	雪人兄弟 - 尼克和湯姆 (set 2)	Toaplan
snowbrob	雪人兄弟 - 尼克和湯姆 (set 3)	雪人兄弟 - 尼克和湯姆 (set 3)	Toaplan
snowbroc	雪人兄弟 - 尼克和湯姆 (set 4)	雪人兄弟 - 尼克和湯姆 (set 4)	Toaplan
snowbroj	雪人兄弟 - 尼克和湯姆 (日本版)	雪人兄弟 - 尼克和湯姆 (日本版)	Toaplan
wintbob	雪人兄弟 - 尼克和湯姆 / The Winter Bobble	雪人兄弟 - 尼克和湯姆 / The Winter Bobble	bootleg
honeydol	雪人兄弟 - 尼克和湯姆 / Honey Dolls	雪人兄弟 - 尼克和湯姆 / Honey Dolls	Barko Corp.
hyperpac	瘋狂小精靈	瘋狂小精靈	SemiCom
hyperpcb	瘋狂小精靈 (盜版)	瘋狂小精靈 (盜版)	bootleg
snowbro3	雪人兄弟 3 - 魔法冒險	雪人兄弟 3 - 魔法冒險	bootleg
truxton2	達人王 (日本版)	達人王 (日本版)	Toaplan
pipibibs	皮皮與比比 / Pipi & Bibis	皮皮與比比 / Pipi & Bibis	Toaplan
whoopee	皮皮與比比 / Whoopee!!	皮皮與比比 / Whoopee!!	Toaplan
pipibibi	皮皮與比比 / Pipi & Bibis (盜版 ?)	皮皮與比比 / Pipi & Bibis (盜版 ?)	[Toaplan] Ryouta Kikaku
fixeight	地獄的英雄傳說	地獄的英雄傳說	Toaplan
fixeighb	地獄的英雄傳說 (盜版)	地獄的英雄傳說 (盜版)	bootleg
batsugun	霹靂雷電 (set 1)	霹靂雷電 (set 1)	Toaplan
batsugna	霹靂雷電 (set 2)	霹靂雷電 (set 2)	Toaplan
batugnsp	霹靂雷電 (Special Ver.)	霹靂雷電 (Special Ver.)	Toaplan
snowbro2	雪人兄弟 2 / Otenki Paradise	雪人兄弟 2 / Otenki Paradise	[Toaplan] Hanafram
sstriker	魔法大作戰 / Sorcer Striker (世界版)	魔法大作戰 / Sorcer Striker (世界版)	Raizing
sstrikra	魔法大作戰 / Sorcer Striker (世界版, alt)	魔法大作戰 / Sorcer Striker (世界版, alt)	Raizing
mahoudai	魔法大作戰 (日本版)	魔法大作戰 (日本版)	Raizing (Able license)
shippumd	疾風魔法大作戰 (日本版)	疾風魔法大作戰 (日本版)	Raizing / Eighting
kingdmgp	疾風魔法大作戰 / Kingdom Grandprix (世界版)	疾風魔法大作戰 / Kingdom Grandprix (世界版)	Raizing / Eighting
pwrinst2	豪血寺一族 2 / Power Instinct 2 (美國版)	豪血寺一族 2 / Power Instinct 2 (美國版)	Atlus/Cave
pwrins2j	豪血寺一族 2 (日本版)	豪血寺一族 2 (日本版)	Atlus/Cave
plegends	豪血寺外傳 最強傳說 / Power Instinct Legends (美國版)	豪血寺外傳 最強傳說 / Power Instinct Legends (美國版)	Atlus/Cave
plegendj	豪血寺外傳 最強傳說 (日本版)	豪血寺外傳 最強傳說 (日本版)	Atlus/Cave
mazinger	無敵鐵金剛 Z	無敵鐵金剛 Z	Banpresto/Dynamic Pl. Toei Animation
donpachi	首領蜂 (美國版)	首領蜂 (美國版)	Atlus/Cave
donpachj	首領蜂 (日本版)	首領蜂 (日本版)	Atlus/Cave
donpachk	首領蜂 (韓國版)	首領蜂 (韓國版)	Atlus/Cave
metmqstr	隱忍 / Metamoqester	隱忍 / Metamoqester	Banpresto/Pandorabox
nmaster	隱忍 (日本版)	隱忍 (日本版)	Banpresto/Pandorabox
sailormn	美少女戰士 (95/03/22B)	美少女戰士 (95/03/22B)	Banpresto
sailormo	美少女戰士 (95/03/22)	美少女戰士 (95/03/22)	Banpresto
hotdogst	眩之風暴	眩之風暴	Marble
ddonpach	怒首領蜂 (國際版)	怒首領蜂 (國際版)	Atlus/Cave
ddonpchj	怒首領蜂 (日本版)	怒首領蜂 (日本版)	Atlus/Cave
dfeveron	彈銃男爵 (日本版)	彈銃男爵 (日本版)	Cave (Nihon System license)
feversos	彈銃男爵 / Fever SOS (國際版)	彈銃男爵 / Fever SOS (國際版)	Cave (Nihon System license)
uopoko	小貓釣魚 (國際版)	小貓釣魚 (國際版)	Cave (Jaleco license)
uopokoj	小貓釣魚 (日本版)	小貓釣魚 (日本版)	Cave (Jaleco license)
guwange	獄門山物語 (日本版)	獄門山物語 (日本版)	Atlus/Cave
gaia	征戰者	征戰者	Noise Factory
sonofphx	鳳凰之子	鳳凰之子	Associated Overseas MFR, Inc
repulse	鳳凰之子 / Repulse	鳳凰之子 / Repulse	Sega
99lstwar	鳳凰之子 / '99: The Last War	鳳凰之子 / '99: The Last War	Proma
99lstwra	鳳凰之子 / '99: The Last War (alternate)	鳳凰之子 / '99: The Last War (alternate)	Proma
99lstwrk	鳳凰之子 / '99: The Last War (Kyugo)	鳳凰之子 / '99: The Last War (Kyugo)	Kyugo
srdmissn	S.R.D. 任務	S.R.D. 任務	Taito Corporation
fx	S.R.D. 任務 / F-X	S.R.D. 任務 / F-X	bootleg
airwolf	天狼	天狼	Kyugo
skywolf	天狼 / Sky Wolf (set 1)	天狼 / Sky Wolf (set 1)	bootleg
skywolf2	天狼 / Sky Wolf (set 2)	天狼 / Sky Wolf (set 2)	bootleg
defender	防衛者 (Red label)	防衛者 (Red label)	Williams
defendg	防衛者 (Green label)	防衛者 (Green label)	Williams
defendw	防衛者 (White label)	防衛者 (White label)	Williams
defndjeu	防衛者 (盜版)	防衛者 (盜版)	Jeutel
tornado1	防衛者 / Tornado (盜版 set 1)	防衛者 / Tornado (盜版 set 1)	Jeutel
tornado2	防衛者 / Tornado (盜版 set 2)	防衛者 / Tornado (盜版 set 2)	Jeutel
zero	防衛者 / Zero	防衛者 / Zero	Jeutel
defcmnd	防衛者 / Defense Command (set 1)	防衛者 / Defense Command (set 1)	bootleg
defence	防衛者 / Defense Command	防衛者 / Defense Command	Outer Limits
startrkd	防衛者 / Star Trek (Defender 盜版)	防衛者 / Star Trek (Defender 盜版)	bootleg
sonson	西遊記	西遊記	Capcom
sonsonj	西遊記 (日本版)	西遊記 (日本版)	Capcom
commando	戰場之狼 / Commando (世界版)	戰場之狼 / Commando (世界版)	Capcom
commandu	戰場之狼 / Commando (美國版)	戰場之狼 / Commando (美國版)	Capcom (Data East USA license)
commandj	戰場之狼	戰場之狼	Capcom
sinvasn	戰場之狼 / Space Invasion (歐洲版)	戰場之狼 / Space Invasion (歐洲版)	Capcom
sinvasnb	戰場之狼 / Space Invasion (盜版)	戰場之狼 / Space Invasion (盜版)	bootleg
gng	魔界村 / Ghosts'n Goblins (世界版? set 1)	魔界村 / Ghosts'n Goblins (世界版? set 1)	Capcom
gnga	魔界村 / Ghosts'n Goblins (世界版? set 2)	魔界村 / Ghosts'n Goblins (世界版? set 2)	Capcom
gngt	魔界村 / Ghosts'n Goblins (美國版)	魔界村 / Ghosts'n Goblins (美國版)	Capcom (Taito America license)
makaimur	魔界村 (日本版)	魔界村 (日本版)	Capcom
makaimuc	魔界村 (日本版 Revision C)	魔界村 (日本版 Revision C)	Capcom
makaimug	魔界村 (日本版 Revision G)	魔界村 (日本版 Revision G)	Capcom
gunsmoke	西部神槍手 (世界版)	西部神槍手 (世界版)	Capcom
gunsmoku	西部神槍手 (美國版 set 1)	西部神槍手 (美國版 set 1)	Capcom (Romstar license)
gunsmoka	西部神槍手 (美國版 set 2)	西部神槍手 (美國版 set 2)	Capcom (Romstar license)
gunsmokj	西部神槍手 (日本版)	西部神槍手 (日本版)	Capcom
trojan	鬥者輓歌 / Trojan (美國版)	鬥者輓歌 / Trojan (美國版)	Capcom
trojanr	鬥者輓歌 / Trojan (Romstar)	鬥者輓歌 / Trojan (Romstar)	Capcom (Romstar license)
trojanj	鬥者輓歌 (日本版)	鬥者輓歌 (日本版)	Capcom
lwings	翼人 / Legendary Wings (美國版 set 1)	翼人 / Legendary Wings (美國版 set 1)	Capcom
lwings2	翼人 / Legendary Wings (美國版 set 2)	翼人 / Legendary Wings (美國版 set 2)	Capcom
lwingsjp	翼人 (日本版)	翼人 (日本版)	Capcom
sidearms	絕對合體 (世界版)	絕對合體 (世界版)	Capcom
sidearmr	絕對合體 (美國版)	絕對合體 (美國版)	Capcom (Romstar license)
sidearjp	絕對合體 (日本版)	絕對合體 (日本版)	Capcom
avengers	必殺 無賴拳 / Avengers (美國版 set 1)	必殺 無賴拳 / Avengers (美國版 set 1)	Capcom
avenger2	必殺 無賴拳 / Avengers (美國版 set 2)	必殺 無賴拳 / Avengers (美國版 set 2)	Capcom
buraiken	必殺 無賴拳 (日本版)	必殺 無賴拳 (日本版)	Capcom
bionicc	最高機密 / 生化指令 (美國版 set 1)	最高機密 / 生化指令 (美國版 set 1)	Capcom
bionicc2	最高機密 / 生化指令 (美國版 set 2)	最高機密 / 生化指令 (美國版 set 2)	Capcom
topsecrt	最高機密 (日本版)	最高機密 (日本版)	Capcom
1943	1943: 中途島海戰 (美國版)	1943: 中途島海戰 (美國版)	Capcom
1943j	1943: 中途島海戰 (日本版)	1943: 中途島海戰 (日本版)	Capcom
blktiger	黑龍 / 黑虎	黑龍 / 黑虎	Capcom
bktigerb	黑龍 / 黑虎 (盜版)	黑龍 / 黑虎 (盜版)	bootleg
blkdrgon	黑龍	黑龍	Capcom
blkdrgnb	黑龍 (盜版)	黑龍 (盜版)	bootleg
sf	快打旋風 (世界版)	快打旋風 (世界版)	Capcom
sfus	快打旋風 (美國版)	快打旋風 (美國版)	Capcom
sfjp	快打旋風 (日本版)	快打旋風 (日本版)	Capcom
sfp	快打旋風 (開發版)	快打旋風 (開發版)	Capcom
tigeroad	虎之道 / Tiger Road (美國版)	虎之道 / Tiger Road (美國版)	Capcom (Romstar license)
toramich	虎之道 (日本版)	虎之道 (日本版)	Capcom
tigerodb	虎之道 / Tiger Road (美國版 盜版)	虎之道 / Tiger Road (美國版 盜版)	bootleg
f1dream	F-1 之夢	F-1 之夢	Capcom (Romstar license)
f1dreamb	F-1 之夢 (盜版)	F-1 之夢 (盜版)	bootleg
1943kai	1943 改: 中途島海戰 (日本版)	1943 改: 中途島海戰 (日本版)	Capcom
lastduel	決戰 (美國版 set 1)	決戰 (美國版 set 1)	Capcom
lstduela	決戰 (美國版 set 2)	決戰 (美國版 set 2)	Capcom
lstduelb	決戰 (盜版)	決戰 (盜版)	bootleg
madgear	瘋狂機車 (美國版)	瘋狂機車 (美國版)	Capcom
madgearj	瘋狂機車 (日本版)	瘋狂機車 (日本版)	Capcom
ledstorm	瘋狂機車 / Led Storm (美國版)	瘋狂機車 / Led Storm (美國版)	Capcom
forgottn	世界末日 / Forgotten Worlds (美國版)	世界末日 / Forgotten Worlds (美國版)	Capcom
lostwrld	世界末日 (日本版)	世界末日 (日本版)	Capcom
ghouls	大魔界村 / Ghouls'n Ghosts (世界版)	大魔界村 / Ghouls'n Ghosts (世界版)	Capcom
ghoulsu	大魔界村 / Ghouls'n Ghosts (美國版)	大魔界村 / Ghouls'n Ghosts (美國版)	Capcom
daimakai	大魔界村 (日本版)	大魔界村 (日本版)	Capcom
strider	出擊飛龍 / Strider (美國版 set 1)	出擊飛龍 / Strider (美國版 set 1)	Capcom
stridrua	出擊飛龍 / Strider (美國版 set 2)	出擊飛龍 / Strider (美國版 set 2)	Capcom
striderj	出擊飛龍 (日本版 set 1)	出擊飛龍 (日本版 set 1)	Capcom
stridrja	出擊飛龍 (日本版 set 2)	出擊飛龍 (日本版 set 2)	Capcom
dynwar	吞食天地 / Dynasty Wars (世界版)	吞食天地 / Dynasty Wars (世界版)	Capcom
dynwarj	吞食天地 (日本版)	吞食天地 (日本版)	Capcom
willow	威洛之旅 (美國版)	威洛之旅 (美國版)	Capcom
willowj	威洛之旅 (日本版, 日文)	威洛之旅 (日本版, 日文)	Capcom
willowje	威洛之旅 (日本版, 英文)	威洛之旅 (日本版, 英文)	Capcom
unsquad	戰區 88 / U.N. Squadron (美國版)	戰區 88 / U.N. Squadron (美國版)	Capcom
area88	戰區 88 (日本版)	戰區 88 (日本版)	Capcom
ffight	街頭快打 (世界版)	街頭快打 (世界版)	Capcom
ffightu	街頭快打 (美國版 900112)	街頭快打 (美國版 900112)	Capcom
ffightua	街頭快打 (美國版 900613)	街頭快打 (美國版 900613)	Capcom
ffightj	街頭快打 (日本版)	街頭快打 (日本版)	Capcom
ffightj1	街頭快打 (日本版 900305)	街頭快打 (日本版 900305)	Capcom
1941	1941 - 反擊 (世界版)	1941 - 反擊 (世界版)	Capcom
1941j	1941 - 反擊 (日本版)	1941 - 反擊 (日本版)	Capcom
mercs	戰場之狼 II / Mercs (世界版 900302)	戰場之狼 II / Mercs (世界版 900302)	Capcom
mercsu	戰場之狼 II / Mercs (美國版 900302)	戰場之狼 II / Mercs (美國版 900302)	Capcom
mercsua	戰場之狼 II / Mercs (美國版 900608)	戰場之狼 II / Mercs (美國版 900608)	Capcom
mercsj	戰場之狼 II (日本版 900302)	戰場之狼 II (日本版 900302)	Capcom
mtwins	雙麟兒 / Mega Twins (世界版 900619)	雙麟兒 / Mega Twins (世界版 900619)	Capcom
chikij	雙麟兒 (日本版 900619)	雙麟兒 (日本版 900619)	Capcom
msword	魔劍 (世界版 900725)	魔劍 (世界版 900725)	Capcom
mswordr1	魔劍 (世界版 900623)	魔劍 (世界版 900623)	Capcom
mswordu	魔劍 (美國版 900725)	魔劍 (美國版 900725)	Capcom
mswordj	魔劍 (日本版 900623)	魔劍 (日本版 900623)	Capcom
cawing	美國海軍 / Carrier Air Wing (世界版 901012)	美國海軍 / Carrier Air Wing (世界版 901012)	Capcom
cawingr1	美國海軍 / Carrier Air Wing (世界版 901009)	美國海軍 / Carrier Air Wing (世界版 901009)	Capcom
cawingu	美國海軍 / Carrier Air Wing (美國版 901012)	美國海軍 / Carrier Air Wing (美國版 901012)	Capcom
cawingj	美國海軍 (日本版 901012)	美國海軍 (日本版 901012)	Capcom
nemo	夢幻冒險 (世界版 901130)	夢幻冒險 (世界版 901130)	Capcom
nemoj	夢幻冒險 (日本版 901120)	夢幻冒險 (日本版 901120)	Capcom
sf2	快打旋風 II (世界版 910522)	快打旋風 II (世界版 910522)	Capcom
sf2eb	快打旋風 II (世界版 910214)	快打旋風 II (世界版 910214)	Capcom
sf2ua	快打旋風 II (美國版 910206)	快打旋風 II (美國版 910206)	Capcom
sf2ub	快打旋風 II (美國版 910214)	快打旋風 II (美國版 910214)	Capcom
sf2ud	快打旋風 II (美國版 910318)	快打旋風 II (美國版 910318)	Capcom
sf2ue	快打旋風 II (美國版 910228)	快打旋風 II (美國版 910228)	Capcom
sf2uf	快打旋風 II (美國版 910411)	快打旋風 II (美國版 910411)	Capcom
sf2ui	快打旋風 II (美國版 910522)	快打旋風 II (美國版 910522)	Capcom
sf2uk	快打旋風 II (美國版 911101)	快打旋風 II (美國版 911101)	Capcom
sf2j	快打旋風 II (日本版 911210)	快打旋風 II (日本版 911210)	Capcom
sf2ja	快打旋風 II (日本版 910214)	快打旋風 II (日本版 910214)	Capcom
sf2jc	快打旋風 II (日本版 910306)	快打旋風 II (日本版 910306)	Capcom
3wonders	神奇三合一 / Three Wonders (世界版 910520)	神奇三合一 / Three Wonders (世界版 910520)	Capcom
3wonderu	神奇三合一 / Three Wonders (美國版 910520)	神奇三合一 / Three Wonders (美國版 910520)	Capcom
wonder3	神奇三合一 (日本版 910520)	神奇三合一 (日本版 910520)	Capcom
kod	龍王 (世界版 910711)	龍王 (世界版 910711)	Capcom
kodu	龍王 (美國版 910910)	龍王 (美國版 910910)	Capcom
kodj	龍王 (日本版 910805)	龍王 (日本版 910805)	Capcom
kodb	龍王 (盜版)	龍王 (盜版)	bootleg
captcomm	上尉密令 (世界版 911014)	上尉密令 (世界版 911014)	Capcom
captcomu	上尉密令 (美國版 910928)	上尉密令 (美國版 910928)	Capcom
captcomj	上尉密令 (日本版 911202)	上尉密令 (日本版 911202)	Capcom
knights	圓桌武士 (世界版 911127)	圓桌武士 (世界版 911127)	Capcom
knightsu	圓桌武士 (美國版 911127)	圓桌武士 (美國版 911127)	Capcom
knightsj	圓桌武士 (日本版 911127)	圓桌武士 (日本版 911127)	Capcom
knightsh	圓桌武士 (hack)	圓桌武士 (hack)	hack
knightsb	圓桌武士 (盜版)	圓桌武士 (盜版)	bootleg
sf2ce	快打旋風 II' - 四大天王 (世界版 920313)	快打旋風 II' - 四大天王 (世界版 920313)	Capcom
sf2ceua	快打旋風 II' - 四大天王 (美國版 920313)	快打旋風 II' - 四大天王 (美國版 920313)	Capcom
sf2ceub	快打旋風 II' - 四大天王 (美國版 920513)	快打旋風 II' - 四大天王 (美國版 920513)	Capcom
sf2ceuc	快打旋風 II' - 四大天王 (美國版 920803)	快打旋風 II' - 四大天王 (美國版 920803)	Capcom
sf2cej	快打旋風 II' - 四大天王 (日本版 920513)	快打旋風 II' - 四大天王 (日本版 920513)	Capcom
sf2rb	快打旋風 II' - 四大天王 (彩虹版 set 1)	快打旋風 II' - 四大天王 (彩虹版 set 1)	hack
sf2rb2	快打旋風 II' - 四大天王 (彩虹版 set 2)	快打旋風 II' - 四大天王 (彩虹版 set 2)	hack
sf2red	快打旋風 II' - 四大天王 (赤色波動)	快打旋風 II' - 四大天王 (赤色波動)	hack
sf2v004	快打旋風 II! - 四大天王 (V004)	快打旋風 II! - 四大天王 (V004)	hack
sf2accp2	快打旋風 II' - 四大天王 (加速版 Pt.II)	快打旋風 II' - 四大天王 (加速版 Pt.II)	hack
sf2m1	快打旋風 II' - 四大天王 (M1)	快打旋風 II' - 四大天王 (M1)	hack
sf2m2	快打旋風 II' - 四大天王 (M2)	快打旋風 II' - 四大天王 (M2)	hack
sf2m3	快打旋風 II' - 四大天王 (M3)	快打旋風 II' - 四大天王 (M3)	hack
sf2m4	快打旋風 II' - 四大天王 (M4)	快打旋風 II' - 四大天王 (M4)	hack
sf2m5	快打旋風 II' - 四大天王 (M5)	快打旋風 II' - 四大天王 (M5)	hack
sf2m6	快打旋風 II' - 四大天王 (降龍 set 2)	快打旋風 II' - 四大天王 (降龍 set 2)	hack
sf2m7	快打旋風 II' - 四大天王 (M7)	快打旋風 II' - 四大天王 (M7)	hack
sf2m8	快打旋風 II' - 四大天王 (M8)	快打旋風 II' - 四大天王 (M8)	hack
sf2m13	快打旋風 II' - 四大天王 (M13)	快打旋風 II' - 四大天王 (M13)	hack
sf2ceh	快打旋風 II' - 四大天王 (西班牙版 990804)	快打旋風 II' - 四大天王 (西班牙版 990804)	hack
sf2tlona	快打旋風 II' - 四大天王 (屠龍 set 1)	快打旋風 II' - 四大天王 (屠龍 set 1)	hack
sf2tlonb	快打旋風 II' - 四大天王 (屠龍 set 2)	快打旋風 II' - 四大天王 (屠龍 set 2)	hack
sf2yyc	快打旋風 II' - 四大天王 (YYC)	快打旋風 II' - 四大天王 (YYC)	hack
sf2koryu	快打旋風 II' - 四大天王 (降龍 set 1)	快打旋風 II' - 四大天王 (降龍 set 1)	hack
varth	雷電風暴 / 威虎戰機 (世界版 920714)	雷電風暴 / 威虎戰機 (世界版 920714)	Capcom
varthr1	雷電風暴 / 威虎戰機 (世界版 920612)	雷電風暴 / 威虎戰機 (世界版 920612)	Capcom
varthu	雷電風暴 / 威虎戰機 (美國版 920612)	雷電風暴 / 威虎戰機 (美國版 920612)	Capcom (Romstar license)
varthj	雷電風暴 / 威虎戰機 (日本版 920714)	雷電風暴 / 威虎戰機 (日本版 920714)	Capcom
cworld2j	冒險問答 卡普空世界 2 (日本版 920611)	冒險問答 卡普空世界 2 (日本版 920611)	Capcom
wof	吞食天地 II - 赤壁之戰 / Warriors of Fate (世界版 921002)	吞食天地 II - 赤壁之戰 / Warriors of Fate (世界版 921002)	Capcom
wofa	吞食天地 II - 赤壁之戰 / 三國誌 II (亞洲版 921005)	吞食天地 II - 赤壁之戰 / 三國誌 II (亞洲版 921005)	Capcom
wofu	吞食天地 II - 赤壁之戰 / Warriors of Fate (美國版 921031)	吞食天地 II - 赤壁之戰 / Warriors of Fate (美國版 921031)	Capcom
wofj	吞食天地 II - 赤壁之戰 (日本版 921031)	吞食天地 II - 赤壁之戰 (日本版 921031)	Capcom
wofb	吞食天地 II - 赤壁之戰 / Warriors of Fate (盜版)	吞食天地 II - 赤壁之戰 / Warriors of Fate (盜版)	bootleg
wofsj	吞食天地 II - 赤壁之戰 / 聖劍三國 (set 1)	吞食天地 II - 赤壁之戰 / 聖劍三國 (set 1)	hack
wofsja	吞食天地 II - 赤壁之戰 / 聖劍三國 (set 2)	吞食天地 II - 赤壁之戰 / 聖劍三國 (set 2)	hack
wofsjb	吞食天地 II - 赤壁之戰 / 聖劍三國 (set 3)	吞食天地 II - 赤壁之戰 / 聖劍三國 (set 3)	hack
wof3js	吞食天地 II - 赤壁之戰 / 三劍聖	吞食天地 II - 赤壁之戰 / 三劍聖	hack
wof3sj	吞食天地 II - 赤壁之戰 / 三聖劍 (set 1)	吞食天地 II - 赤壁之戰 / 三聖劍 (set 1)	hack
wof3sja	吞食天地 II - 赤壁之戰 / 三聖劍 (set 2)	吞食天地 II - 赤壁之戰 / 三聖劍 (set 2)	hack
wofh	吞食天地 II - 赤壁之戰 / 三國英雄傳 (set 1)	吞食天地 II - 赤壁之戰 / 三國英雄傳 (set 1)	hack
wofha	吞食天地 II - 赤壁之戰 / 三國英雄傳 (set 2)	吞食天地 II - 赤壁之戰 / 三國英雄傳 (set 2)	hack
sf2hf	快打旋風 II' - 激戰 (世界版 921209)	快打旋風 II' - 激戰 (世界版 921209)	Capcom
sf2t	快打旋風 II' - 激戰 (美國版 921209)	快打旋風 II' - 激戰 (美國版 921209)	Capcom
sf2tj	快打旋風 II' TURBO - 激戰 (日本版 921209)	快打旋風 II' TURBO - 激戰 (日本版 921209)	Capcom
dino	恐龍新世紀 / Cadillacs and Dinosaurs (世界版 930201)	恐龍新世紀 / Cadillacs and Dinosaurs (世界版 930201)	Capcom
dinou	恐龍新世紀 / Cadillacs and Dinosaurs (美國版 930201)	恐龍新世紀 / Cadillacs and Dinosaurs (美國版 930201)	Capcom
dinoj	恐龍新世紀 (日本版 930201)	恐龍新世紀 (日本版 930201)	Capcom
dinob	恐龍新世紀 / Cadillacs and Dinosaurs (盜版)	恐龍新世紀 / Cadillacs and Dinosaurs (盜版)	bootleg
dinoh	恐龍新世紀 / Cadillacs and Dinosaurs (hack set 1)	恐龍新世紀 / Cadillacs and Dinosaurs (hack set 1)	hack
dinoha	恐龍新世紀 / Cadillacs and Dinosaurs (hack set 2)	恐龍新世紀 / Cadillacs and Dinosaurs (hack set 2)	hack
dinohb	恐龍新世紀 / Cadillacs and Dinosaurs (hack set 3)	恐龍新世紀 / Cadillacs and Dinosaurs (hack set 3)	hack
punisher	毀滅者 (世界版 930422)	毀滅者 (世界版 930422)	Capcom
punishru	毀滅者 (美國版 930422)	毀滅者 (美國版 930422)	Capcom
punishrj	毀滅者 (日本版 930422)	毀滅者 (日本版 930422)	Capcom
slammast	摔角霸王 / Saturday Night Slam Masters (世界版 930713)	摔角霸王 / Saturday Night Slam Masters (世界版 930713)	Capcom
slammasu	摔角霸王 / Saturday Night Slam Masters (美國版 930713)	摔角霸王 / Saturday Night Slam Masters (美國版 930713)	Capcom
mbomberj	摔角霸王 (日本版 930713)	摔角霸王 (日本版 930713)	Capcom
mbombrd	摔角霸王 / Muscle Bomber Duo - Ultimate Team Battle (世界版 931206)	摔角霸王 / Muscle Bomber Duo - Ultimate Team Battle (世界版 931206)	Capcom
mbombrdj	摔角霸王 / Muscle Bomber Duo - Heat Up Warriors (日本版 931206)	摔角霸王 / Muscle Bomber Duo - Heat Up Warriors (日本版 931206)	Capcom
pnickj	智慧女神魔法寶石 (日本版 940608)	智慧女神魔法寶石 (日本版 940608)	Compile (Capcom license)
pnicku	智慧女神魔法寶石 (美國版 940608)	智慧女神魔法寶石 (美國版 940608)	Compile (Capcom license)
qad	龍之謎題 (美國版 920701)	龍之謎題 (美國版 920701)	Capcom
qadj	龍之謎題 (日本版 940921)	龍之謎題 (日本版 940921)	Capcom
qtono2	問答殿樣之野望 2 全國版 (日本版 950123)	問答殿樣之野望 2 全國版 (日本版 950123)	Capcom
pang3	魔鬼氣球! 3 - 怪盜的華麗午後 (歐洲版 950511)	魔鬼氣球! 3 - 怪盜的華麗午後 (歐洲版 950511)	Mitchell
pang3j	魔鬼氣球! 3 - 怪盜的華麗午後 (日本版 950511)	魔鬼氣球! 3 - 怪盜的華麗午後 (日本版 950511)	Mitchell
megaman	洛克人 - 力量對決 / Mega Man - The Power Battle (CPS1 亞洲版 951006)	洛克人 - 力量對決 / Mega Man - The Power Battle (CPS1 亞洲版 951006)	Capcom
rockmanj	洛克人 - 力量對決 (CPS1 日本版 950922)	洛克人 - 力量對決 (CPS1 日本版 950922)	Capcom
sfzch	少年快打 ZERO (CPS Changer 日本版 951020)	少年快打 ZERO (CPS Changer 日本版 951020)	Capcom
sfach	少年快打 ZERO / Street Fighter Alpha (Publicity 美國版 950727)	少年快打 ZERO / Street Fighter Alpha (Publicity 美國版 950727)	Capcom
fcrash	街頭快打 / Final Crash (世界版, 盜版)	街頭快打 / Final Crash (世界版, 盜版)	Playmark, bootleg [Capcom]
ssf2	超級快打旋風 II: 新挑戰者 (世界版 930911)	超級快打旋風 II: 新挑戰者 (世界版 930911)	Capcom
ssf2u	超級快打旋風 II: 新挑戰者 (美國版 930911)	超級快打旋風 II: 新挑戰者 (美國版 930911)	Capcom
ssf2a	超級快打旋風 II: 新挑戰者 (亞洲版 931005)	超級快打旋風 II: 新挑戰者 (亞洲版 931005)	Capcom
ssf2ar1	超級快打旋風 II: 新挑戰者 (亞洲版 930914)	超級快打旋風 II: 新挑戰者 (亞洲版 930914)	Capcom
ssf2j	超級快打旋風 II: 新挑戰者 (日本版 931005)	超級快打旋風 II: 新挑戰者 (日本版 931005)	Capcom
ssf2jr1	超級快打旋風 II: 新挑戰者 (日本版 930911)	超級快打旋風 II: 新挑戰者 (日本版 930911)	Capcom
ssf2jr2	超級快打旋風 II: 新挑戰者 (日本版 930910)	超級快打旋風 II: 新挑戰者 (日本版 930910)	Capcom
ssf2tb	超級快打旋風 II: 錦標賽 (世界版 931119)	超級快打旋風 II: 錦標賽 (世界版 931119)	Capcom
ssf2tbr1	超級快打旋風 II: 錦標賽 (世界版 930911)	超級快打旋風 II: 錦標賽 (世界版 930911)	Capcom
ssf2tbj	超級快打旋風 II: 錦標賽 (日本版 930911)	超級快打旋風 II: 錦標賽 (日本版 930911)	Capcom
ecofghtr	扭轉戰鬥機 / Eco Fighters (世界版 931203)	扭轉戰鬥機 / Eco Fighters (世界版 931203)	Capcom
ecofghtu	扭轉戰鬥機 / Eco Fighters (美國版 931203)	扭轉戰鬥機 / Eco Fighters (美國版 931203)	Capcom
ecofghta	扭轉戰鬥機 / Eco Fighters (亞洲版 931203)	扭轉戰鬥機 / Eco Fighters (亞洲版 931203)	Capcom
uecology	扭轉戰鬥機 (日本版 931203)	扭轉戰鬥機 (日本版 931203)	Capcom
ddtod	地獄神龍 / 龍與地下城: 毀滅之塔 (歐洲版 940412)	地獄神龍 / 龍與地下城: 毀滅之塔 (歐洲版 940412)	Capcom
ddtodr1	地獄神龍 / 龍與地下城: 毀滅之塔 (歐洲版 940113)	地獄神龍 / 龍與地下城: 毀滅之塔 (歐洲版 940113)	Capcom
ddtodu	地獄神龍 / 龍與地下城: 毀滅之塔 (美國版 940125)	地獄神龍 / 龍與地下城: 毀滅之塔 (美國版 940125)	Capcom
ddtodur1	地獄神龍 / 龍與地下城: 毀滅之塔 (美國版 940113)	地獄神龍 / 龍與地下城: 毀滅之塔 (美國版 940113)	Capcom
ddtodj	地獄神龍 / 龍與地下城: 毀滅之塔 (日本版 940125)	地獄神龍 / 龍與地下城: 毀滅之塔 (日本版 940125)	Capcom
ddtodjr1	地獄神龍 / 龍與地下城: 毀滅之塔 (日本版 940113)	地獄神龍 / 龍與地下城: 毀滅之塔 (日本版 940113)	Capcom
ddtoda	地獄神龍 / 龍與地下城: 毀滅之塔 (亞洲版 940113)	地獄神龍 / 龍與地下城: 毀滅之塔 (亞洲版 940113)	Capcom
ddtodh	地獄神龍 / 龍與地下城: 毀滅之塔 (西班牙版 940125)	地獄神龍 / 龍與地下城: 毀滅之塔 (西班牙版 940125)	Capcom
ssf2t	超級快打旋風 II TURBO (世界版 940223)	超級快打旋風 II TURBO (世界版 940223)	Capcom
ssf2tu	超級快打旋風 II TURBO (美國版 940323)	超級快打旋風 II TURBO (美國版 940323)	Capcom
ssf2tur1	超級快打旋風 II TURBO (美國版 940223)	超級快打旋風 II TURBO (美國版 940223)	Capcom
ssf2ta	超級快打旋風 II TURBO (亞洲版 940223)	超級快打旋風 II TURBO (亞洲版 940223)	Capcom
ssf2xj	超級快打旋風 II X (日本版 940223)	超級快打旋風 II X (日本版 940223)	Capcom
avsp	異形 VS. 終極戰士 (歐洲版 940520)	異形 VS. 終極戰士 (歐洲版 940520)	Capcom
avspu	異形 VS. 終極戰士 (美國版 940520)	異形 VS. 終極戰士 (美國版 940520)	Capcom
avspj	異形 VS. 終極戰士 (日本版 940520)	異形 VS. 終極戰士 (日本版 940520)	Capcom
avspa	異形 VS. 終極戰士 (亞洲版 940520)	異形 VS. 終極戰士 (亞洲版 940520)	Capcom
avsph	異形 VS. 終極戰士 (西班牙版 940520)	異形 VS. 終極戰士 (西班牙版 940520)	Capcom
dstlk	魔域幽靈: 午夜鬥士 / Darkstalkers: The Night Warriors (歐洲版 940705)	魔域幽靈: 午夜鬥士 / Darkstalkers: The Night Warriors (歐洲版 940705)	Capcom
dstlku	魔域幽靈: 午夜鬥士 / Darkstalkers: The Night Warriors (美國版 940818)	魔域幽靈: 午夜鬥士 / Darkstalkers: The Night Warriors (美國版 940818)	Capcom
dstlkur1	魔域幽靈: 午夜鬥士 / Darkstalkers: The Night Warriors (美國版 940705)	魔域幽靈: 午夜鬥士 / Darkstalkers: The Night Warriors (美國版 940705)	Capcom
dstlka	魔域幽靈: 午夜鬥士 / Darkstalkers: The Night Warriors (亞洲版 940705)	魔域幽靈: 午夜鬥士 / Darkstalkers: The Night Warriors (亞洲版 940705)	Capcom
vampj	魔域幽靈: 午夜鬥士 (日本版 940705)	魔域幽靈: 午夜鬥士 (日本版 940705)	Capcom
vampja	魔域幽靈: 午夜鬥士 (日本版 940705 alt)	魔域幽靈: 午夜鬥士 (日本版 940705 alt)	Capcom
vampjr1	魔域幽靈: 午夜鬥士 (日本版 940630)	魔域幽靈: 午夜鬥士 (日本版 940630)	Capcom
ringdest	超級摔角霸王: 連環爆裂 / Ring of Destruction: Slammasters II (歐洲版 940902)	超級摔角霸王: 連環爆裂 / Ring of Destruction: Slammasters II (歐洲版 940902)	Capcom
smbomb	超級摔角霸王: 連環爆裂 (日本版 940831)	超級摔角霸王: 連環爆裂 (日本版 940831)	Capcom
smbombr1	超級摔角霸王: 連環爆裂 (日本版 940808)	超級摔角霸王: 連環爆裂 (日本版 940808)	Capcom
armwar	裝甲戰士 / Armored Warriors (歐洲版 941024)	裝甲戰士 / Armored Warriors (歐洲版 941024)	Capcom
armwarr1	裝甲戰士 / Armored Warriors (歐洲版 941011)	裝甲戰士 / Armored Warriors (歐洲版 941011)	Capcom
armwaru	裝甲戰士 / Armored Warriors (美國版 941024)	裝甲戰士 / Armored Warriors (美國版 941024)	Capcom
pgear	裝甲戰士 (日本版 941024)	裝甲戰士 (日本版 941024)	Capcom
pgearr1	裝甲戰士 (日本版 940916)	裝甲戰士 (日本版 940916)	Capcom
armwara	裝甲戰士 (亞洲版 940920)	裝甲戰士 (亞洲版 940920)	Capcom
xmcota	X 戰警: 原子人 (歐洲版 950105)	X 戰警: 原子人 (歐洲版 950105)	Capcom
xmcotau	X 戰警: 原子人 (美國版 950105)	X 戰警: 原子人 (美國版 950105)	Capcom
xmcotah	X 戰警: 原子人 (西班牙版 950331)	X 戰警: 原子人 (西班牙版 950331)	Capcom
xmcotaj	X 戰警: 原子人 (日本版 941219)	X 戰警: 原子人 (日本版 941219)	Capcom
xmcotaj1	X 戰警: 原子人 (日本版 941217)	X 戰警: 原子人 (日本版 941217)	Capcom
xmcotaa	X 戰警: 原子人 (亞洲版 941217)	X 戰警: 原子人 (亞洲版 941217)	Capcom
xmcotajr	X 戰警: 原子人 (日本版 941208 rent version)	X 戰警: 原子人 (日本版 941208 rent version)	Capcom
nwarr	魔域幽靈: 惡魔的復仇 / Night Warriors: Darkstalkers' Revenge (美國版 950406)	魔域幽靈: 惡魔的復仇 / Night Warriors: Darkstalkers' Revenge (美國版 950406)	Capcom
nwarrh	魔域幽靈: 惡魔的復仇 / Night Warriors: Darkstalkers' Revenge (西班牙版 950403)	魔域幽靈: 惡魔的復仇 / Night Warriors: Darkstalkers' Revenge (西班牙版 950403)	Capcom
nwarrb	魔域幽靈: 惡魔的復仇 / Night Warriors: Darkstalkers' Revenge (巴西版 950403)	魔域幽靈: 惡魔的復仇 / Night Warriors: Darkstalkers' Revenge (巴西版 950403)	Capcom
vhuntj	魔域幽靈: 惡魔的復仇 (日本版 950316)	魔域幽靈: 惡魔的復仇 (日本版 950316)	Capcom
vhuntjr1	魔域幽靈: 惡魔的復仇 (日本版 950307)	魔域幽靈: 惡魔的復仇 (日本版 950307)	Capcom
vhuntjr2	魔域幽靈: 惡魔的復仇 (日本版 950302)	魔域幽靈: 惡魔的復仇 (日本版 950302)	Capcom
cybots	機甲格鬥 (歐洲版 950424)	機甲格鬥 (歐洲版 950424)	Capcom
cybotsu	機甲格鬥 (美國版 950424)	機甲格鬥 (美國版 950424)	Capcom
cybotsj	機甲格鬥 (日本版 950420)	機甲格鬥 (日本版 950420)	Capcom
sfa	少年快打 ZERO / Street Fighter Alpha: Warriors' Dreams (歐洲版 950727)	少年快打 ZERO / Street Fighter Alpha: Warriors' Dreams (歐洲版 950727)	Capcom
sfar1	少年快打 ZERO / Street Fighter Alpha: Warriors' Dreams (歐洲版 950718)	少年快打 ZERO / Street Fighter Alpha: Warriors' Dreams (歐洲版 950718)	Capcom
sfar2	少年快打 ZERO / Street Fighter Alpha: Warriors' Dreams (歐洲版 950627)	少年快打 ZERO / Street Fighter Alpha: Warriors' Dreams (歐洲版 950627)	Capcom
sfar3	少年快打 ZERO / Street Fighter Alpha: Warriors' Dreams (歐洲版 950605)	少年快打 ZERO / Street Fighter Alpha: Warriors' Dreams (歐洲版 950605)	Capcom
sfau	少年快打 ZERO / Street Fighter Alpha: Warriors' Dreams (美國版 950627)	少年快打 ZERO / Street Fighter Alpha: Warriors' Dreams (美國版 950627)	Capcom
sfza	少年快打 ZERO (亞洲版 950627)	少年快打 ZERO (亞洲版 950627)	Capcom
sfzj	少年快打 ZERO (日本版 950727)	少年快打 ZERO (日本版 950727)	Capcom
sfzjr1	少年快打 ZERO (日本版 950627)	少年快打 ZERO (日本版 950627)	Capcom
sfzjr2	少年快打 ZERO (日本版 950605)	少年快打 ZERO (日本版 950605)	Capcom
sfzh	少年快打 ZERO (西班牙版 950627)	少年快打 ZERO (西班牙版 950627)	Capcom
sfzb	少年快打 ZERO (巴西版 951109)	少年快打 ZERO (巴西版 951109)	Capcom
sfzbr1	少年快打 ZERO (巴西版 950727)	少年快打 ZERO (巴西版 950727)	Capcom
rckmanj	洛克人: 力量對決 (日本版 950922)	洛克人: 力量對決 (日本版 950922)	Capcom
msh	美國漫畫英雄 (歐洲版 951024)	美國漫畫英雄 (歐洲版 951024)	Capcom
mshu	美國漫畫英雄 (美國版 951024)	美國漫畫英雄 (美國版 951024)	Capcom
mshj	美國漫畫英雄 (日本版 951117)	美國漫畫英雄 (日本版 951117)	Capcom
mshjr1	美國漫畫英雄 (日本版 951024)	美國漫畫英雄 (日本版 951024)	Capcom
msha	美國漫畫英雄 (亞洲版 951024)	美國漫畫英雄 (亞洲版 951024)	Capcom
mshh	美國漫畫英雄 (西班牙版 951117)	美國漫畫英雄 (西班牙版 951117)	Capcom
mshb	美國漫畫英雄 (巴西版 951117)	美國漫畫英雄 (巴西版 951117)	Capcom
19xx	19XX: 命運否決戰 (美國版 951207)	19XX: 命運否決戰 (美國版 951207)	Capcom
19xxj	19XX: 命運否決戰 (日本版 951225)	19XX: 命運否決戰 (日本版 951225)	Capcom
19xxjr1	19XX: 命運否決戰 (日本版 951207)	19XX: 命運否決戰 (日本版 951207)	Capcom
19xxa	19XX: 命運否決戰 (亞洲版 951207)	19XX: 命運否決戰 (亞洲版 951207)	Capcom
19xxh	19XX: 命運否決戰 (西班牙版 951218)	19XX: 命運否決戰 (西班牙版 951218)	Capcom
ddsom	地獄神龍二 / 龍與地下城: 暗黑秘影 (歐洲版 960619)	地獄神龍二 / 龍與地下城: 暗黑秘影 (歐洲版 960619)	Capcom
ddsomr1	地獄神龍二 / 龍與地下城: 暗黑秘影 (歐洲版 960223)	地獄神龍二 / 龍與地下城: 暗黑秘影 (歐洲版 960223)	Capcom
ddsomr2	地獄神龍二 / 龍與地下城: 暗黑秘影 (歐洲版 960209)	地獄神龍二 / 龍與地下城: 暗黑秘影 (歐洲版 960209)	Capcom
ddsomu	地獄神龍二 / 龍與地下城: 暗黑秘影 (美國版 960619)	地獄神龍二 / 龍與地下城: 暗黑秘影 (美國版 960619)	Capcom
ddsomur1	地獄神龍二 / 龍與地下城: 暗黑秘影 (美國版 960209)	地獄神龍二 / 龍與地下城: 暗黑秘影 (美國版 960209)	Capcom
ddsomjr1	地獄神龍二 / 龍與地下城: 暗黑秘影 (日本版 960206)	地獄神龍二 / 龍與地下城: 暗黑秘影 (日本版 960206)	Capcom
ddsomj	地獄神龍二 / 龍與地下城: 暗黑秘影 (日本版 960619)	地獄神龍二 / 龍與地下城: 暗黑秘影 (日本版 960619)	Capcom
ddsoma	地獄神龍二 / 龍與地下城: 暗黑秘影 (亞洲版 960619)	地獄神龍二 / 龍與地下城: 暗黑秘影 (亞洲版 960619)	Capcom
sfa2	少年快打 ZERO 2 / Street Fighter Alpha 2 (美國版 960306)	少年快打 ZERO 2 / Street Fighter Alpha 2 (美國版 960306)	Capcom
sfz2j	少年快打 ZERO 2 (日本版 960227)	少年快打 ZERO 2 (日本版 960227)	Capcom
sfz2a	少年快打 ZERO 2 (亞洲版 960227)	少年快打 ZERO 2 (亞洲版 960227)	Capcom
sfz2b	少年快打 ZERO 2 (巴西版 960531)	少年快打 ZERO 2 (巴西版 960531)	Capcom
sfz2br1	少年快打 ZERO 2 (巴西版 960304)	少年快打 ZERO 2 (巴西版 960304)	Capcom
sfz2h	少年快打 ZERO 2 (西班牙版 960304)	少年快打 ZERO 2 (西班牙版 960304)	Capcom
sfz2n	少年快打 ZERO 2 (大洋洲版 960229)	少年快打 ZERO 2 (大洋洲版 960229)	Capcom
spf2t	超級快打方塊 II TURBO (美國版 960620)	超級快打方塊 II TURBO (美國版 960620)	Capcom
spf2xj	超級快打方塊 II X (日本版 960531)	超級快打方塊 II X (日本版 960531)	Capcom
spf2ta	超級快打方塊 II TURBO (亞洲版 960529)	超級快打方塊 II TURBO (亞洲版 960529)	Capcom
qndream	問答七彩夢: 虹色町的奇跡 (日本版 960826)	問答七彩夢: 虹色町的奇跡 (日本版 960826)	Capcom
megaman2	洛克人 2: 力量對決 / Mega Man 2: The Power Fighters (美國版 960708)	洛克人 2: 力量對決 / Mega Man 2: The Power Fighters (美國版 960708)	Capcom
megamn2a	洛克人 2: 力量對決 / Mega Man 2: The Power Fighters (亞洲版 960708)	洛克人 2: 力量對決 / Mega Man 2: The Power Fighters (亞洲版 960708)	Capcom
rckman2j	洛克人 2: 力量對決 (日本版 960708)	洛克人 2: 力量對決 (日本版 960708)	Capcom
sfz2aj	少年快打 ZERO 2 ALPHA (日本版 960805)	少年快打 ZERO 2 ALPHA (日本版 960805)	Capcom
sfz2ah	少年快打 ZERO 2 ALPHA (西班牙版 960813)	少年快打 ZERO 2 ALPHA (西班牙版 960813)	Capcom
sfz2ab	少年快打 ZERO 2 ALPHA (巴西版 960813)	少年快打 ZERO 2 ALPHA (巴西版 960813)	Capcom
sfz2aa	少年快打 ZERO 2 ALPHA (亞洲版 960826)	少年快打 ZERO 2 ALPHA (亞洲版 960826)	Capcom
xmvsf	X 戰警 VS. 快打旋風 (歐洲版 961004)	X 戰警 VS. 快打旋風 (歐洲版 961004)	Capcom
xmvsfr1	X 戰警 VS. 快打旋風 (歐洲版 960910)	X 戰警 VS. 快打旋風 (歐洲版 960910)	Capcom
xmvsfu	X 戰警 VS. 快打旋風 (美國版 961023)	X 戰警 VS. 快打旋風 (美國版 961023)	Capcom
xmvsfur1	X 戰警 VS. 快打旋風 (美國版 961004)	X 戰警 VS. 快打旋風 (美國版 961004)	Capcom
xmvsfj	X 戰警 VS. 快打旋風 (日本版 961004)	X 戰警 VS. 快打旋風 (日本版 961004)	Capcom
xmvsfjr1	X 戰警 VS. 快打旋風 (日本版 960910)	X 戰警 VS. 快打旋風 (日本版 960910)	Capcom
xmvsfjr2	X 戰警 VS. 快打旋風 (日本版 960909)	X 戰警 VS. 快打旋風 (日本版 960909)	Capcom
xmvsfa	X 戰警 VS. 快打旋風 (亞洲版 961023)	X 戰警 VS. 快打旋風 (亞洲版 961023)	Capcom
xmvsfar1	X 戰警 VS. 快打旋風 (亞洲版 960919)	X 戰警 VS. 快打旋風 (亞洲版 960919)	Capcom
xmvsfh	X 戰警 VS. 快打旋風 (西班牙版 961004)	X 戰警 VS. 快打旋風 (西班牙版 961004)	Capcom
xmvsfb	X 戰警 VS. 快打旋風 (巴西版 961023)	X 戰警 VS. 快打旋風 (巴西版 961023)	Capcom
batcir	戰鬥回路 (歐洲版 970319)	戰鬥回路 (歐洲版 970319)	Capcom
batcirj	戰鬥回路 (日本版 970319)	戰鬥回路 (日本版 970319)	Capcom
batcira	戰鬥回路 (亞洲版 970319)	戰鬥回路 (亞洲版 970319)	Capcom
vsav	魔域幽靈: 惡魔救世主 (歐洲版 970519)	魔域幽靈: 惡魔救世主 (歐洲版 970519)	Capcom
vsavu	魔域幽靈: 惡魔救世主 (美國版 970519)	魔域幽靈: 惡魔救世主 (美國版 970519)	Capcom
vsavj	魔域幽靈: 惡魔救世主 (日本版 970519)	魔域幽靈: 惡魔救世主 (日本版 970519)	Capcom
vsava	魔域幽靈: 惡魔救世主 (亞洲版 970519)	魔域幽靈: 惡魔救世主 (亞洲版 970519)	Capcom
vsavh	魔域幽靈: 惡魔救世主 (西班牙版 970519)	魔域幽靈: 惡魔救世主 (西班牙版 970519)	Capcom
mshvsf	美國漫畫英雄 VS. 快打旋風 (歐洲版 970625)	美國漫畫英雄 VS. 快打旋風 (歐洲版 970625)	Capcom
mshvsfu	美國漫畫英雄 VS. 快打旋風 (美國版 970827)	美國漫畫英雄 VS. 快打旋風 (美國版 970827)	Capcom
mshvsfu1	美國漫畫英雄 VS. 快打旋風 (美國版 970625)	美國漫畫英雄 VS. 快打旋風 (美國版 970625)	Capcom
mshvsfj	美國漫畫英雄 VS. 快打旋風 (日本版 970707)	美國漫畫英雄 VS. 快打旋風 (日本版 970707)	Capcom
mshvsfj1	美國漫畫英雄 VS. 快打旋風 (日本版 970702)	美國漫畫英雄 VS. 快打旋風 (日本版 970702)	Capcom
mshvsfj2	美國漫畫英雄 VS. 快打旋風 (日本版 970625)	美國漫畫英雄 VS. 快打旋風 (日本版 970625)	Capcom
mshvsfh	美國漫畫英雄 VS. 快打旋風 (西班牙版 970625)	美國漫畫英雄 VS. 快打旋風 (西班牙版 970625)	Capcom
mshvsfa	美國漫畫英雄 VS. 快打旋風 (亞洲版 970625)	美國漫畫英雄 VS. 快打旋風 (亞洲版 970625)	Capcom
mshvsfa1	美國漫畫英雄 VS. 快打旋風 (亞洲版 970620)	美國漫畫英雄 VS. 快打旋風 (亞洲版 970620)	Capcom
mshvsfb	美國漫畫英雄 VS. 快打旋風 (巴西版 970827)	美國漫畫英雄 VS. 快打旋風 (巴西版 970827)	Capcom
mshvsfb1	美國漫畫英雄 VS. 快打旋風 (巴西版 970625)	美國漫畫英雄 VS. 快打旋風 (巴西版 970625)	Capcom
csclub	卡普空運動俱樂部 (歐洲版 970722)	卡普空運動俱樂部 (歐洲版 970722)	Capcom
csclubj	卡普空運動俱樂部 (日本版 970722)	卡普空運動俱樂部 (日本版 970722)	Capcom
cscluba	卡普空運動俱樂部 (亞洲版 970722)	卡普空運動俱樂部 (亞洲版 970722)	Capcom
csclubh	卡普空運動俱樂部 (西班牙版 970722)	卡普空運動俱樂部 (西班牙版 970722)	Capcom
sgemf	口袋快打 / Super Gem Fighter Mini Mix (美國版 970904)	口袋快打 / Super Gem Fighter Mini Mix (美國版 970904)	Capcom
pfghtj	口袋快打 (日本版 970904)	口袋快打 (日本版 970904)	Capcom
sgemfa	口袋快打 / Super Gem Fighter Mini Mix (亞洲版 970904)	口袋快打 / Super Gem Fighter Mini Mix (亞洲版 970904)	Capcom
sgemfh	口袋快打 / Super Gem Fighter Mini Mix (西班牙版 970904)	口袋快打 / Super Gem Fighter Mini Mix (西班牙版 970904)	Capcom
vhunt2r1	魔域幽靈 2: 惡魔的復仇 (日本版 970913)	魔域幽靈 2: 惡魔的復仇 (日本版 970913)	Capcom
vhunt2	魔域幽靈 2: 惡魔的復仇 (日本版 970929)	魔域幽靈 2: 惡魔的復仇 (日本版 970929)	Capcom
vsav2	魔域幽靈 2: 惡魔救世主 (日本版 970913)	魔域幽靈 2: 惡魔救世主 (日本版 970913)	Capcom
mvsc	美國漫畫英雄 VS. 卡普空英雄 (歐洲版 980112)	美國漫畫英雄 VS. 卡普空英雄 (歐洲版 980112)	Capcom
mvscu	美國漫畫英雄 VS. 卡普空英雄 (美國版 980123)	美國漫畫英雄 VS. 卡普空英雄 (美國版 980123)	Capcom
mvscj	美國漫畫英雄 VS. 卡普空英雄 (日本版 980123)	美國漫畫英雄 VS. 卡普空英雄 (日本版 980123)	Capcom
mvscjr1	美國漫畫英雄 VS. 卡普空英雄 (日本版 980112)	美國漫畫英雄 VS. 卡普空英雄 (日本版 980112)	Capcom
mvsca	美國漫畫英雄 VS. 卡普空英雄 (亞洲版 980123)	美國漫畫英雄 VS. 卡普空英雄 (亞洲版 980123)	Capcom
mvscar1	美國漫畫英雄 VS. 卡普空英雄 (亞洲版 980112)	美國漫畫英雄 VS. 卡普空英雄 (亞洲版 980112)	Capcom
mvsch	美國漫畫英雄 VS. 卡普空英雄 (西班牙版 980123)	美國漫畫英雄 VS. 卡普空英雄 (西班牙版 980123)	Capcom
mvscb	美國漫畫英雄 VS. 卡普空英雄 (巴西版 980123)	美國漫畫英雄 VS. 卡普空英雄 (巴西版 980123)	Capcom
sfa3	少年快打 ZERO 3 / Street Fighter Alpha 3 (美國版 980904)	少年快打 ZERO 3 / Street Fighter Alpha 3 (美國版 980904)	Capcom
sfa3r1	少年快打 ZERO 3 / Street Fighter Alpha 3 (美國版 980629)	少年快打 ZERO 3 / Street Fighter Alpha 3 (美國版 980629)	Capcom
sfa3b	少年快打 ZERO 3 / Street Fighter Alpha 3 (巴西版 980629)	少年快打 ZERO 3 / Street Fighter Alpha 3 (巴西版 980629)	Capcom
sfz3j	少年快打 ZERO 3 (日本版 980904)	少年快打 ZERO 3 (日本版 980904)	Capcom
sfz3jr1	少年快打 ZERO 3 (日本版 980727)	少年快打 ZERO 3 (日本版 980727)	Capcom
sfz3jr2	少年快打 ZERO 3 (日本版 980629)	少年快打 ZERO 3 (日本版 980629)	Capcom
sfz3a	少年快打 ZERO 3 (亞洲版 980904)	少年快打 ZERO 3 (亞洲版 980904)	Capcom
sfz3ar1	少年快打 ZERO 3 (亞洲版 980701)	少年快打 ZERO 3 (亞洲版 980701)	Capcom
gigawing	激鋼之翼 (美國版 990222)	激鋼之翼 (美國版 990222)	Capcom, supported by Takumi
gwingj	激鋼之翼 (日本版 990223)	激鋼之翼 (日本版 990223)	Capcom, supported by Takumi
gwinga	激鋼之翼 (亞洲版 990222)	激鋼之翼 (亞洲版 990222)	Capcom, supported by Takumi
dimahoo	偉大魔法大作戰 / Dimahoo (美國版 000121)	偉大魔法大作戰 / Dimahoo (美國版 000121)	Eighting/Raizing, distributed by Capcom
gmahou	偉大魔法大作戰 (日本版 000121)	偉大魔法大作戰 (日本版 000121)	Eighting/Raizing, distributed by Capcom
mmatrix	火星任務: 彈丸地獄 (美國版 000412)	火星任務: 彈丸地獄 (美國版 000412)	Capcom, supported by Takumi
mmatrixj	火星任務: 彈丸地獄 (日本版 000412)	火星任務: 彈丸地獄 (日本版 000412)	Capcom, supported by Takumi
1944	1944: 特技大師 (美國版 000620)	1944: 特技大師 (美國版 000620)	Capcom, supported by Eighting/Raizing
1944j	1944: 特技大師 (日本版 000620)	1944: 特技大師 (日本版 000620)	Capcom, supported by Eighting/Raizing
mpangj	強力! 魔鬼氣球 (日本版 001011)	強力! 魔鬼氣球 (日本版 001011)	Mitchell, distributed by Capcom
progear	能源之嵐 / Progear (美國版 010117)	能源之嵐 / Progear (美國版 010117)	Capcom, supported by Cave
progearj	能源之嵐 (日本版 010117)	能源之嵐 (日本版 010117)	Capcom, supported by Cave
progeara	能源之嵐 / Progear (亞洲版 010117)	能源之嵐 / Progear (亞洲版 010117)	Capcom, supported by Cave
pzloop2j	渦輪泡泡 2 (日本版 010205)	渦輪泡泡 2 (日本版 010205)	Mitchell, distributed by Capcom
choko	雀牌解謎 長江 (日本版 010820)	雀牌解謎 長江 (日本版 010820)	Mitchell, distributed by Capcom
warzard	赤色大地	赤色大地	Capcom
sfiii	快打旋風 III: 新世代	快打旋風 III: 新世代	Capcom
jojo	JoJo 的奇妙冒險	JoJo 的奇妙冒險	Capcom
jojoba	JoJo 的奇妙冒險: 未來的遺產	JoJo 的奇妙冒險: 未來的遺產	Capcom
jojobaa	JoJo 的奇妙冒險: 未來的遺產 (alt)	JoJo 的奇妙冒險: 未來的遺產 (alt)	Capcom
sfiii2	快打旋風 III 二次衝擊: 巨型攻擊	快打旋風 III 二次衝擊: 巨型攻擊	Capcom
sfiii3	快打旋風 III 三度攻擊: 未來格鬥	快打旋風 III 三度攻擊: 未來格鬥	Capcom
ts2	鬥神傳 2 (美國版 951124)	鬥神傳 2 (美國版 951124)	Capcom/Takara
ts2j	鬥神傳 2 (日本版 951124)	鬥神傳 2 (日本版 951124)	Capcom/Takara
starglad	星劍格鬥 (美國版 960627)	星劍格鬥 (美國版 960627)	Capcom
sfex	快打旋風 EX (美國版 961219)	快打旋風 EX (美國版 961219)	Capcom/Arika
sfexa	快打旋風 EX (亞洲版 961219)	快打旋風 EX (亞洲版 961219)	Capcom/Arika
sfexj	快打旋風 EX (日本版 961130)	快打旋風 EX (日本版 961130)	Capcom/Arika
glpracr	疾風快馬 (日本版 Ver 9.01.12)	疾風快馬 (日本版 Ver 9.01.12)	Tecmo
sfexp	快打旋風 EX PLUS (美國版 970407)	快打旋風 EX PLUS (美國版 970407)	Capcom/Arika
sfexpu1	快打旋風 EX PLUS (美國版 970311)	快打旋風 EX PLUS (美國版 970311)	Capcom/Arika
sfexpj	快打旋風 EX PLUS (日本版 970311)	快打旋風 EX PLUS (日本版 970311)	Capcom/Arika
rvschool	私立正義學園 / Rival Schools (美國版 971117)	私立正義學園 / Rival Schools (美國版 971117)	Capcom
rvschola	私立正義學園 / Rival Schools (亞洲版 971117)	私立正義學園 / Rival Schools (亞洲版 971117)	Capcom
jgakuen	私立正義學園 (日本版 971117)	私立正義學園 (日本版 971117)	Capcom
sfex2	快打旋風 EX 2 (美國版 980526)	快打旋風 EX 2 (美國版 980526)	Capcom/Arika
sfex2j	快打旋風 EX 2 (日本版 980312)	快打旋風 EX 2 (日本版 980312)	Capcom/Arika
sfex2a	快打旋風 EX 2 (亞洲版 980312)	快打旋風 EX 2 (亞洲版 980312)	Capcom/Arika
plsmaswd	星劍格鬥 2 / Plasma Sword (美國版 980316)	星劍格鬥 2 / Plasma Sword (美國版 980316)	Capcom
stargld2	星劍格鬥 2 (日本版 980316)	星劍格鬥 2 (日本版 980316)	Capcom
plsmswda	星劍格鬥 2 / Plasma Sword (亞洲版 980316)	星劍格鬥 2 / Plasma Sword (亞洲版 980316)	Capcom
tgmj	俄羅斯方塊大師 (日本版 980710)	俄羅斯方塊大師 (日本版 980710)	Capcom/Arika
techromn	超鋼戰記 / Tech Romancer (歐洲版 980914)	超鋼戰記 / Tech Romancer (歐洲版 980914)	Capcom
techromu	超鋼戰記 / Tech Romancer (美國版 980914)	超鋼戰記 / Tech Romancer (美國版 980914)	Capcom
kikaioh	超鋼戰記 (日本版 980914)	超鋼戰記 (日本版 980914)	Capcom
sfex2p	快打旋風 EX 2 PLUS (美國版 990611)	快打旋風 EX 2 PLUS (美國版 990611)	Capcom/Arika
sfex2pa	快打旋風 EX 2 PLUS (亞洲版 990611)	快打旋風 EX 2 PLUS (亞洲版 990611)	Capcom/Arika
sfex2pj	快打旋風 EX 2 PLUS (日本版 990611)	快打旋風 EX 2 PLUS (日本版 990611)	Capcom/Arika
strider2	出擊飛龍 2 / Strider 2 (美國版 991213)	出擊飛龍 2 / Strider 2 (美國版 991213)	Capcom
stridr2a	出擊飛龍 2 / Strider 2 (亞洲版 991213)	出擊飛龍 2 / Strider 2 (亞洲版 991213)	Capcom
shiryu2	出擊飛龍 2 (日本版 991213)	出擊飛龍 2 (日本版 991213)	Capcom
glpracr2	疾風快馬 2 (美國版)	疾風快馬 2 (美國版)	Tecmo
glprac2j	疾風快馬 2 (日本版)	疾風快馬 2 (日本版)	Tecmo
glprac2l	疾風快馬 2 Link HW (日本版)	疾風快馬 2 Link HW (日本版)	Tecmo
doapp	生死格鬥 ++ (日本版)	生死格鬥 ++ (日本版)	Tecmo
cbaj	滑雪風雲	滑雪風雲	Tecmo
shngmtkb	上海 - 真的武勇	上海 - 真的武勇	Sunsoft / Activision
tondemo	危機降臨 (日本版)	危機降臨 (日本版)	Tecmo
glpracr3	疾風快馬 3 (日本版)	疾風快馬 3 (日本版)	Tecmo
flamegun	烈火戰士	烈火戰士	GAPS Inc.
flameguj	烈火戰士 (日本版)	烈火戰士 (日本版)	GAPS Inc.
tecmowcm	Tecmo 世界盃足球 千禧年 (日本版)	Tecmo 世界盃足球 千禧年 (日本版)	Tecmo
mfjump	極速跳跳樂 (日本版)	極速跳跳樂 (日本版)	Tecmo
hvnsgate	天堂之門	天堂之門	Atlus/RACDYM
beastrzr	獸人格鬥 / Beastorizer (美國版)	獸人格鬥 / Beastorizer (美國版)	Eighting/Raizing
beastrzb	獸人格鬥 / Beastorizer (美國版 盜版)	獸人格鬥 / Beastorizer (美國版 盜版)	Eighting/Raizing
bldyror2	獸人格鬥 2 (日本版)	獸人格鬥 2 (日本版)	Eighting/Raizing
brvblade	幻象戰機 (日本版)	幻象戰機 (日本版)	Eighting/Raizing
primrag2	恐龍格鬥 2 (Ver 0.36a)	恐龍格鬥 2 (Ver 0.36a)	Atari
nbajamex	NBA 勁爆籃球	NBA 勁爆籃球	Acclaim
jdredd	超時空戰警 (Rev C Dec. 17 1997)	超時空戰警 (Rev C Dec. 17 1997)	Acclaim
jdreddb	超時空戰警 (Rev B Nov. 26 1997)	超時空戰警 (Rev B Nov. 26 1997)	Acclaim
sncwgltd	音速戰機 LIMITED (日本版)	音速戰機 LIMITED (日本版)	Video System
sfchamp	超級美式足球冠軍 (Ver 2.5O)	超級美式足球冠軍 (Ver 2.5O)	Taito
sfchampj	超級美式足球冠軍 (Ver 2.4J)	超級美式足球冠軍 (Ver 2.4J)	Taito
psyforce	超能力大戰 (Ver 2.4O)	超能力大戰 (Ver 2.4O)	Taito
psyforcj	超能力大戰 (Ver 2.4J)	超能力大戰 (Ver 2.4J)	Taito
psyfrcex	超能力大戰 EX (Ver 2.0J)	超能力大戰 EX (Ver 2.0J)	Taito
mgcldate	魔法假期 - 心跳告白大作戰 (Ver 2.02J)	魔法假期 - 心跳告白大作戰 (Ver 2.02J)	Taito
mgcldtex	魔法假期 - 卒業告白大作戰 (Ver 2.01J)	魔法假期 - 卒業告白大作戰 (Ver 2.01J)	Taito
raystorm	閃電風暴 (Ver 2.06A)	閃電風暴 (Ver 2.06A)	Taito
raystorj	閃電風暴 (Ver 2.05J)	閃電風暴 (Ver 2.05J)	Taito
gdarius	太空戰鬥機 G (Ver 2.01J)	太空戰鬥機 G (Ver 2.01J)	Taito
gdariusb	太空戰鬥機 G (Ver 2.02A)	太空戰鬥機 G (Ver 2.02A)	Taito
gdarius2	太空戰鬥機 G Ver.2 (Ver 2.03J)	太空戰鬥機 G Ver.2 (Ver 2.03J)	Taito
tekken	鐵拳 (TE4/VER.C)	鐵拳 (TE4/VER.C)	Namco
tekkena	鐵拳 (TE2/VER.C)	鐵拳 (TE2/VER.C)	Namco
tekkenb	鐵拳 (TE2/VER.B)	鐵拳 (TE2/VER.B)	Namco
tekkenc	鐵拳 (TE1/VER.B)	鐵拳 (TE1/VER.B)	Namco
tekken2	鐵拳 2 Ver.B (TES3/VER.B)	鐵拳 2 Ver.B (TES3/VER.B)	Namco
tekken2a	鐵拳 2 Ver.B (TES2/VER.B)	鐵拳 2 Ver.B (TES2/VER.B)	Namco
tekken2b	鐵拳 2 (TES2/VER.A)	鐵拳 2 (TES2/VER.A)	Namco
souledge	刀魂 Ver. II (SO4/VER.C)	刀魂 Ver. II (SO4/VER.C)	Namco
souledga	刀魂 Ver. II (SO3/VER.C)	刀魂 Ver. II (SO3/VER.C)	Namco
souledgb	刀魂 (SO3/VER.A)	刀魂 (SO3/VER.A)	Namco
souledgc	刀魂 (SO1/VER.A)	刀魂 (SO1/VER.A)	Namco
xevi3dg	鐵板陣 3D (XV31/VER.A)	鐵板陣 3D (XV31/VER.A)	Namco
danceyes	麗舞之眼 (DC1/VER.A)	麗舞之眼 (DC1/VER.A)	Namco
myangel3	育嬰問答 親親小寶貝 3 (KQT1/VER.A)	育嬰問答 親親小寶貝 3 (KQT1/VER.A)	Namco
tekken3	鐵拳 3 (TET1/VER.E1)	鐵拳 3 (TET1/VER.E1)	Namco
tekken3a	鐵拳 3 (TET2/VER.B)	鐵拳 3 (TET2/VER.B)	Namco
tekken3b	鐵拳 3 (TET2/VER.A)	鐵拳 3 (TET2/VER.A)	Namco
soulclbr	劍魂 (SOC14/VER.C)	劍魂 (SOC14/VER.C)	Namco
soulclba	劍魂 (SOC11/VER.C)	劍魂 (SOC11/VER.C)	Namco
soulclbb	劍魂 (SOC11/VER.B)	劍魂 (SOC11/VER.B)	Namco
soulclbc	劍魂 (SOC11/VER.A2)	劍魂 (SOC11/VER.A2)	Namco
tektagt	鐵拳 TT (TEG3/VER.C1)	鐵拳 TT (TEG3/VER.C1)	Namco
tektagta	鐵拳 TT (TEG3/VER.B)	鐵拳 TT (TEG3/VER.B)	Namco
tektagtb	鐵拳 TT (TEG1/VER.B)	鐵拳 TT (TEG1/VER.B)	Namco
tektagtc	鐵拳 TT (TEG1/VER.A3)	鐵拳 TT (TEG1/VER.A3)	Namco
ghlpanic	魔鬼剋星 (OB2/VER.A)	魔鬼剋星 (OB2/VER.A)	Namco
mrdrillr	電鑽先生 (DRI1/VER.A2)	電鑽先生 (DRI1/VER.A2)	Namco
aquarush	水世界方塊 (AQ1/VER.A1)	水世界方塊 (AQ1/VER.A1)	Namco
golgo13	神秘狙擊手 13 (GLG1/VER.A)	神秘狙擊手 13 (GLG1/VER.A)	Raizing/Namco
g13knd	神秘狙擊手 13 奇跡的彈道 (GLS1/VER.A)	神秘狙擊手 13 奇跡的彈道 (GLS1/VER.A)	Raizing/Namco
mrdrilr2	電鑽先生 2 (DR21 Ver.A)	電鑽先生 2 (DR21 Ver.A)	Namco
gjspace	雀地帶 / 擊牌砦 (10011 Ver.A)	雀地帶 / 擊牌砦 (10011 Ver.A)	Namco/Metro
mrdrilrg	電鑽先生 G (DRG1 Ver.A)	電鑽先生 G (DRG1 Ver.A)	Namco
gamshara	銃武者羅 (10021 Ver.A)	銃武者羅 (10021 Ver.A)	Mitchell
cryptklr	殺戮墳場 (GQ420 UAA)	殺戮墳場 (GQ420 UAA)	Konami
pbball96	實況野球 '96 (GV017 日本版 1.03)	實況野球 '96 (GV017 日本版 1.03)	Konami
simpbowl	辛普森家庭保齡球 (GQ829 UAA)	辛普森家庭保齡球 (GQ829 UAA)	Konami
mgakuen	麻雀學園 - 卒業編	麻雀學園 - 卒業編	Yuga
7toitsu	麻雀學園 / 七對子	麻雀學園 / 七對子	Yuga
mgakuen2	麻雀學園 2 - 學園長的復仇	麻雀學園 2 - 學園長的復仇	Face
pkladies	同花順	同花順	Mitchell
pkladiel	同花順 (Leprechaun ver. 510)	同花順 (Leprechaun ver. 510)	Leprechaun
pkladila	同花順 (Leprechaun ver. 401)	同花順 (Leprechaun ver. 401)	Leprechaun
pang	魔鬼氣球 / Pang (世界版)	魔鬼氣球 / Pang (世界版)	Mitchell
pangb	魔鬼氣球 / Pang (盜版)	魔鬼氣球 / Pang (盜版)	bootleg
bbros	魔鬼氣球 / Buster Bros. (美國版)	魔鬼氣球 / Buster Bros. (美國版)	Capcom
pompingw	魔鬼氣球 (日本版)	魔鬼氣球 (日本版)	Mitchell
cbasebal	卡普空棒球 (日本版)	卡普空棒球 (日本版)	Capcom
cworld	冒險問答 卡普空世界 (日本版)	冒險問答 卡普空世界 (日本版)	Capcom
hatena	冒險問答 2 不明物的大冒險 (日本版 900228)	冒險問答 2 不明物的大冒險 (日本版 900228)	Capcom
spang	超級魔鬼氣球 (世界版 900914)	超級魔鬼氣球 (世界版 900914)	Mitchell
spangj	超級魔鬼氣球 (日本版 901023)	超級魔鬼氣球 (日本版 901023)	Mitchell
sbbros	超級魔鬼氣球 / Super Buster Bros. (美國版 901001)	超級魔鬼氣球 / Super Buster Bros. (美國版 901001)	Mitchell + Capcom
marukin	超級麻雀 (禁) 版 (日本版 901017)	超級麻雀 (禁) 版 (日本版 901017)	Yuga
qtono1	問答殿樣之野望 (日本版)	問答殿樣之野望 (日本版)	Capcom
qsangoku	問答三國誌 - 知略的霸者 (日本版)	問答三國誌 - 知略的霸者 (日本版)	Capcom
block	敲磚塊 (世界版 910910)	敲磚塊 (世界版 910910)	Capcom
blockj	敲磚塊 (日本版 910910)	敲磚塊 (日本版 910910)	Capcom
blockjoy	敲磚塊 (世界版 911106 搖桿)	敲磚塊 (世界版 911106 搖桿)	Capcom
blockbl	敲磚塊 (盜版)	敲磚塊 (盜版)	bootleg
capbowl	卡普空保齡球 (set 1)	卡普空保齡球 (set 1)	Incredible Technologies
capbowl2	卡普空保齡球 (set 2)	卡普空保齡球 (set 2)	Incredible Technologies
capbowl3	卡普空保齡球 (set 3)	卡普空保齡球 (set 3)	Incredible Technologies
capbowl4	卡普空保齡球 (set 4)	卡普空保齡球 (set 4)	Incredible Technologies
clbowl	卡普空保齡球 / Coors Light Bowling	卡普空保齡球 / Coors Light Bowling	Incredible Technologies
gtg	金爵高爾夫 (搖桿, v3.1)	金爵高爾夫 (搖桿, v3.1)	Strata/Incredible Technologies
gtgt	金爵高爾夫 (軌跡球, v1.0)	金爵高爾夫 (軌跡球, v1.0)	Strata/Incredible Technologies
gtg2	金爵高爾夫 II (軌跡球, V2.2)	金爵高爾夫 II (軌跡球, V2.2)	Strata/Incredible Technologies
gtg2t	金爵高爾夫 II (軌跡球, V1.1)	金爵高爾夫 II (軌跡球, V1.1)	Strata/Incredible Technologies
gtg2j	金爵高爾夫 II (搖桿, V1.0)	金爵高爾夫 II (搖桿, V1.0)	Strata/Incredible Technologies
pairs	美女撲克 (V1.2, 09/30/94)	美女撲克 (V1.2, 09/30/94)	Strata/Incredible Technologies
pairsa	美女撲克 (09/07/94)	美女撲克 (09/07/94)	Strata/Incredible Technologies
hotmemry	美女撲克 / Hot Memory (V1.2, 德國版)	美女撲克 / Hot Memory (V1.2, 德國版)	Tuning/Incredible Technologies
sftm	快打旋風: 電影版 (v1.12)	快打旋風: 電影版 (v1.12)	Capcom/Incredible Technologies
sftm110	快打旋風: 電影版 (v1.10)	快打旋風: 電影版 (v1.10)	Capcom/Incredible Technologies
sftm111	快打旋風: 電影版 (v1.11)	快打旋風: 電影版 (v1.11)	Capcom/Incredible Technologies
sftmj	快打旋風: 電影版 (v1.12N, 日本版)	快打旋風: 電影版 (v1.12N, 日本版)	Capcom/Incredible Technologies
gt3d	金爵高爾夫 3D (v1.93N)	金爵高爾夫 3D (v1.93N)	Incredible Technologies
gt3dl192	金爵高爾夫 3D (v1.92L)	金爵高爾夫 3D (v1.92L)	Incredible Technologies
gt3dl191	金爵高爾夫 3D (v1.91L)	金爵高爾夫 3D (v1.91L)	Incredible Technologies
gt3ds192	金爵高爾夫 3D (v1.92S)	金爵高爾夫 3D (v1.92S)	Incredible Technologies
gt3dv18	金爵高爾夫 3D (v1.8)	金爵高爾夫 3D (v1.8)	Incredible Technologies
gt3dv17	金爵高爾夫 3D (v1.7)	金爵高爾夫 3D (v1.7)	Incredible Technologies
gt3dv16	金爵高爾夫 3D (v1.6)	金爵高爾夫 3D (v1.6)	Incredible Technologies
gt3dv15	金爵高爾夫 3D (v1.5)	金爵高爾夫 3D (v1.5)	Incredible Technologies
gt3dv14	金爵高爾夫 3D (v1.4)	金爵高爾夫 3D (v1.4)	Incredible Technologies
gt3dt231	金爵高爾夫 3D 錦標賽 (v2.31)	金爵高爾夫 3D 錦標賽 (v2.31)	Incredible Technologies
gt3dt211	金爵高爾夫 3D 錦標賽 (v2.11)	金爵高爾夫 3D 錦標賽 (v2.11)	Incredible Technologies
gt97	金爵高爾夫 '97 (v1.30)	金爵高爾夫 '97 (v1.30)	Incredible Technologies
gt97v122	金爵高爾夫 '97 (v1.22)	金爵高爾夫 '97 (v1.22)	Incredible Technologies
gt97v121	金爵高爾夫 '97 (v1.21)	金爵高爾夫 '97 (v1.21)	Incredible Technologies
gt97s121	金爵高爾夫 '97 (v1.21S)	金爵高爾夫 '97 (v1.21S)	Incredible Technologies
gt97v120	金爵高爾夫 '97 (v1.20)	金爵高爾夫 '97 (v1.20)	Incredible Technologies
gt97t240	金爵高爾夫 '97 錦標賽 (v2.40)	金爵高爾夫 '97 錦標賽 (v2.40)	Incredible Technologies
gt98	金爵高爾夫 '98 (v1.10)	金爵高爾夫 '98 (v1.10)	Incredible Technologies
gt98v100	金爵高爾夫 '98 (v1.00)	金爵高爾夫 '98 (v1.00)	Incredible Technologies
gt98s100	金爵高爾夫 '98 錦標賽 (v1.00S)	金爵高爾夫 '98 錦標賽 (v1.00S)	Incredible Technologies
gt98t303	金爵高爾夫 '98 (v3.03)	金爵高爾夫 '98 (v3.03)	Incredible Technologies
gt99	金爵高爾夫 '99 (v1.00)	金爵高爾夫 '99 (v1.00)	Incredible Technologies
gt99s100	金爵高爾夫 '99 (v1.00S)	金爵高爾夫 '99 (v1.00S)	Incredible Technologies
gt99t400	金爵高爾夫 '99 錦標賽 (v4.00)	金爵高爾夫 '99 錦標賽 (v4.00)	Incredible Technologies
gtroyal	金爵高爾夫 皇家版 錦標賽 (v4.02)	金爵高爾夫 皇家版 錦標賽 (v4.02)	Incredible Technologies
gt2k	金爵高爾夫 2K (v1.00)	金爵高爾夫 2K (v1.00)	Incredible Technologies
gt2ks100	金爵高爾夫 2K (v1.00S)	金爵高爾夫 2K (v1.00S)	Incredible Technologies
gt2kt500	金爵高爾夫 2K 錦標賽 (v5.00)	金爵高爾夫 2K 錦標賽 (v5.00)	Incredible Technologies
gtsuprem	金爵高爾夫 至尊版 錦標賽 (v5.10)	金爵高爾夫 至尊版 錦標賽 (v5.10)	Incredible Technologies
gtclassc	金爵高爾夫 經典賽 (v1.00)	金爵高爾夫 經典賽 (v1.00)	Incredible Technologies
gtclassp	金爵高爾夫 經典賽 (v1.00) Alt	金爵高爾夫 經典賽 (v1.00) Alt	Incredible Technologies
gtcls100	金爵高爾夫 經典賽 (v1.00S)	金爵高爾夫 經典賽 (v1.00S)	Incredible Technologies
wseries	世界大賽: 職棒球季	世界大賽: 職棒球季	Cinematronics
dangerz	危險地帶	危險地帶	Cinematronics
basebal2	棒球季節 II	棒球季節 II	Cinematronics
aafb	美式足球 (rev E)	美式足球 (rev E)	Leland Corp.
aafbd2p	美式足球 (rev D, 2 Players)	美式足球 (rev D, 2 Players)	Leland Corp.
aafbc	美式足球 (rev C)	美式足球 (rev C)	Leland Corp.
aafbb	美式足球 (rev B)	美式足球 (rev B)	Leland Corp.
wsf	世界足球最終戰	世界足球最終戰	Leland Corp.
brutforc	極之暴力	極之暴力	Leland Corp.
mineswpr	掃雷艇	掃雷艇	Amutech
sspaceat	太空攻擊 (直立型 set 1)	太空攻擊 (直立型 set 1)	Sega
sspacat2	太空攻擊 (直立型 set 2)	太空攻擊 (直立型 set 2)	Sega
sspacat3	太空攻擊 (直立型 set 3)	太空攻擊 (直立型 set 3)	Sega
sspacatc	太空攻擊 (檯面型)	太空攻擊 (檯面型)	Sega
sspacaho	太空攻擊 / Head On	太空攻擊 / Head On	Sega
samurai	武士	武士	Sega
carnival	嘉年華會 (直立型)	嘉年華會 (直立型)	Sega
carnvckt	嘉年華會 (檯面型)	嘉年華會 (檯面型)	Sega
heiankyo	平安京異形	平安京異形	Denki Onkyo
bullfgt	鬥牛 / Bullfight	鬥牛 / Bullfight	Coreland / Sega
thetogyu	鬥牛 (日本版)	鬥牛 (日本版)	Coreland / Sega
seganinj	忍者王子 / SEGA 忍者	忍者王子 / SEGA 忍者	Sega
seganinu	忍者王子 / SEGA 忍者 (未加密)	忍者王子 / SEGA 忍者 (未加密)	Sega
ninja	忍者王子	忍者王子	Sega
nprinces	忍者王子 (64k Ver. 盜版?)	忍者王子 (64k Ver. 盜版?)	bootleg?
nprincso	忍者王子 (128k Ver.)	忍者王子 (128k Ver.)	Sega
nprincsu	忍者王子 (64k Ver. 未加密)	忍者王子 (64k Ver. 未加密)	Sega
nprincsb	忍者王子 (128k Ver. 盜版?)	忍者王子 (128k Ver. 盜版?)	bootleg?
myhero	青春物語 / 我的英雄 (美國版)	青春物語 / 我的英雄 (美國版)	Sega
sscandal	青春物語 (日本版)	青春物語 (日本版)	Coreland / Sega
myherok	青春物語 / 我的英雄 (韓國版)	青春物語 / 我的英雄 (韓國版)	Coreland / Sega
4dwarrio	4-D 戰士	4-D 戰士	Coreland / Sega
wboy	神奇男孩 (set 1, 新加密版)	神奇男孩 (set 1, 新加密版)	Sega (Escape license)
wboyo	神奇男孩 (set 1, 舊加密版)	神奇男孩 (set 1, 舊加密版)	Sega (Escape license)
wboy2	神奇男孩 (set 2)	神奇男孩 (set 2)	Sega (Escape license)
wboy2u	神奇男孩 (set 2 未加密)	神奇男孩 (set 2 未加密)	Sega (Escape license)
wboy3	神奇男孩 (set 3)	神奇男孩 (set 3)	Sega (Escape license)
wboyu	神奇男孩 (未加密)	神奇男孩 (未加密)	Sega (Escape license)
wbdeluxe	神奇男孩 / Wonder Boy Deluxe	神奇男孩 / Wonder Boy Deluxe	Sega (Escape license)
wboysys2	神奇男孩 (system 2)	神奇男孩 (system 2)	Sega (Escape license)
tokisens	時間戰士	時間戰士	Sega
wbml	神奇男孩在魔界 (日本版 新版)	神奇男孩在魔界 (日本版 新版)	Sega / Westone
wbmljo	神奇男孩在魔界 (日本版 舊版)	神奇男孩在魔界 (日本版 舊版)	Sega / Westone
wbmljb	神奇男孩在魔界 (日本版 未加密)	神奇男孩在魔界 (日本版 未加密)	bootleg
wbmlb	神奇男孩在魔界 	神奇男孩在魔界 	bootleg
ufosensi	UFO 戰士	UFO 戰士	Sega
ufosensb	UFO 戰士 (未加密)	UFO 戰士 (未加密)	bootleg
transfrm	變形金剛 / Transformer	變形金剛 / Transformer	Sega
astrofl	變形金剛 (日本版)	變形金剛 (日本版)	Sega
tetrisse	俄羅斯方塊 (日本版, System E)	俄羅斯方塊 (日本版, System E)	Sega
sharrier	時空戰士 (Rev A, 8751 315-5163A)	時空戰士 (Rev A, 8751 315-5163A)	Sega
sharrirb	時空戰士 (8751 315-5163)	時空戰士 (8751 315-5163)	Sega
bodyslam	DUMP 松本 / Body Slam (8751 317-unknown)	DUMP 松本 / Body Slam (8751 317-unknown)	Sega
dumpmtmt	DUMP 松本 (日本版, 8751 317-unknown)	DUMP 松本 (日本版, 8751 317-unknown)	Sega
mjleague	大聯盟	大聯盟	Sega
fantzone	神奇地帶 (set 2, unprotected)	神奇地帶 (set 2, unprotected)	Sega
fantzon1	神奇地帶 (set 1, unprotected)	神奇地帶 (set 1, unprotected)	Sega
sdi	SDI - 戰略防衛構想 (歐洲版, System 16A, FD1089B 317-0027)	SDI - 戰略防衛構想 (歐洲版, System 16A, FD1089B 317-0027)	Sega
shinobi	忍 (set 5, System 16A, unprotected)	忍 (set 5, System 16A, unprotected)	Sega
shinobi1	忍 (set 1, System 16A, FD1094 317-0050)	忍 (set 1, System 16A, FD1094 317-0050)	Sega
sjryuko1	水手服雀士龍子 (set 1, System 16A, FD1089B 317-5021)	水手服雀士龍子 (set 1, System 16A, FD1089B 317-5021)	White Board
tetris	俄羅斯方塊 (set 4, 日本版, System 16A, FD1094 317-0093)	俄羅斯方塊 (set 4, 日本版, System 16A, FD1094 317-0093)	Sega
tetris3	俄羅斯方塊 (set 3, 日本版, System 16A, FD1094 317-0093a)	俄羅斯方塊 (set 3, 日本版, System 16A, FD1094 317-0093a)	Sega
wb31	神奇男孩 III - 魔窟 (set 1, System 16A, FD1094 317-0084)	神奇男孩 III - 魔窟 (set 1, System 16A, FD1094 317-0084)	Sega / Westone
altbeast	獸王記 / Altered Beast (set 7, 8751 317-0078)	獸王記 / Altered Beast (set 7, 8751 317-0078)	Sega
altbeasj	獸王記 (set 6, 日本版, 8751 317-0077)	獸王記 (set 6, 日本版, 8751 317-0077)	Sega
altbeas5	獸王記 / Altered Beast (set 5, 8751 317-0076)	獸王記 / Altered Beast (set 5, 8751 317-0076)	Sega
altbeas4	獸王記 / Altered Beast (set 4, MC-8123B 317-0066)	獸王記 / Altered Beast (set 4, MC-8123B 317-0066)	Sega
altbeaj3	獸王記 (set 3, 日本版, FD1094 317-0068)	獸王記 (set 3, 日本版, FD1094 317-0068)	Sega
altbeas2	獸王記 / Altered Beast (set 2, MC-8123B 317-0066)	獸王記 / Altered Beast (set 2, MC-8123B 317-0066)	Sega
altbeaj1	獸王記 (set 1, 日本版, FD1094 317-0065)	獸王記 (set 1, 日本版, FD1094 317-0065)	Sega
cotton	小魔女 (set 3, 世界版, FD1094 317-0181a)	小魔女 (set 3, 世界版, FD1094 317-0181a)	Sega / Success
cottonu	小魔女 (set 2, 美國版, FD1094 317-0180)	小魔女 (set 2, 美國版, FD1094 317-0180)	Sega / Success
cottonj	小魔女 (set 1, 日本版, FD1094 317-0179a)	小魔女 (set 1, 日本版, FD1094 317-0179a)	Sega / Success
ddux	怪鴨冒險記 (set 2, FD1094 317-0096)	怪鴨冒險記 (set 2, FD1094 317-0096)	Sega
ddux1	怪鴨冒險記 (set 1, 8751 317-0095)	怪鴨冒險記 (set 1, 8751 317-0095)	Sega
goldnaxe	戰斧 (set 6, 美國版, 8751 317-123A)	戰斧 (set 6, 美國版, 8751 317-123A)	Sega
goldnaxu	戰斧 (set 5, 美國版, FD1094 317-0122)	戰斧 (set 5, 美國版, FD1094 317-0122)	Sega
goldnaxj	戰斧 (set 4, 日本版, FD1094 317-0121)	戰斧 (set 4, 日本版, FD1094 317-0121)	Sega
goldnax3	戰斧 (set 3, 世界版, FD1094 317-0120)	戰斧 (set 3, 世界版, FD1094 317-0120)	Sega
goldnax2	戰斧 (set 2, 美國版, 8751 317-0112)	戰斧 (set 2, 美國版, 8751 317-0112)	Sega
goldnax1	戰斧 (set 1, 世界版, FD1094 317-0110)	戰斧 (set 1, 世界版, FD1094 317-0110)	Sega
hwchamp	重量拳擊	重量拳擊	Sega
mvp	MVP (set 2, 美國版, FD1094 317-0143)	MVP (set 2, 美國版, FD1094 317-0143)	Sega
mvpj	MVP (set 1, 日本版, FD1094 317-0142)	MVP (set 1, 日本版, FD1094 317-0142)	Sega
riotcity	暴亂之城 (日本版)	暴亂之城 (日本版)	Sega / Westone
ryukyu	琉球 (日本版, FD1094 317-5023)	琉球 (日本版, FD1094 317-5023)	Success / Sega
sdib	SDI - 戰略防衛構想 (System 16B, FD1089A 317-0028)	SDI - 戰略防衛構想 (System 16B, FD1089A 317-0028)	Sega
sdibl	SDI - 戰略防衛構想 (盜版)	SDI - 戰略防衛構想 (盜版)	bootleg
defense	SDI - 戰略防衛構想 / Defense (System 16B, FD1089A 317-0028)	SDI - 戰略防衛構想 / Defense (System 16B, FD1089A 317-0028)	Sega
shinobi4	忍 (set 4, System 16B, unprotected)	忍 (set 4, System 16B, unprotected)	Sega
shinobi3	忍 (set 3, System 16B, unprotected) 	忍 (set 3, System 16B, unprotected) 	Sega
shinobi2	忍 (set 2, System 16B, FD1094 317-0049) 	忍 (set 2, System 16B, FD1094 317-0049) 	Sega
sjryuko	水手服雀士龍子 (set 2, System 16B, FD1089B 317-5021)	水手服雀士龍子 (set 2, System 16B, FD1089B 317-5021)	White Board
tetris2	俄羅斯方塊 (set 2, 日本版, System 16B, FD1094 317-0092)	俄羅斯方塊 (set 2, 日本版, System 16B, FD1094 317-0092)	Sega
tetris1	俄羅斯方塊 (set 1, 日本版, System 16B, FD1094 317-0091)	俄羅斯方塊 (set 1, 日本版, System 16B, FD1094 317-0091)	Sega
toryumon	登龍門	登龍門	Sega
wb3	神奇男孩 III - 魔窟 (set 5, 世界版, System 16B, 8751 317-0098)	神奇男孩 III - 魔窟 (set 5, 世界版, System 16B, 8751 317-0098)	Sega / Westone
wb34	神奇男孩 III - 魔窟 (set 4, 日本版, System 16B, FD1094 317-0087)	神奇男孩 III - 魔窟 (set 4, 日本版, System 16B, FD1094 317-0087)	Sega / Westone
wb33	神奇男孩 III - 魔窟 (set 3, 世界版, System 16B, FD1094 317-0089)	神奇男孩 III - 魔窟 (set 3, 世界版, System 16B, FD1094 317-0089)	Sega / Westone
wb32	神奇男孩 III - 魔窟 (set 2, 日本版, System 16B, FD1094 317-0085)	神奇男孩 III - 魔窟 (set 2, 日本版, System 16B, FD1094 317-0085)	Sega / Westone
dduxbl	怪鴨冒險記 (盜版)	怪鴨冒險記 (盜版)	bootleg
goldnabl	戰斧 (盜版)	戰斧 (盜版)	bootleg
shinobl	忍 (盜版)	忍 (盜版)	bootleg
tetrisbl	俄羅斯方塊 (盜版)	俄羅斯方塊 (盜版)	bootleg
wb3bbl	神奇男孩 III - 魔窟 (盜版)	神奇男孩 III - 魔窟 (盜版)	bootleg
astorm	異形風暴 (set 4, 2 Players, FD1094 317-?)	異形風暴 (set 4, 2 Players, FD1094 317-?)	Sega
astorm3	異形風暴 (set 3, 世界版, 3 Players, FD1094 317-0148)	異形風暴 (set 3, 世界版, 3 Players, FD1094 317-0148)	Sega
astormu	異形風暴 (set 2, 美國版, 3 Players, FD1094 317-0147)	異形風暴 (set 2, 美國版, 3 Players, FD1094 317-0147)	Sega
astormj	異形風暴 (set 1, 日本版, 2 Players, FD1094 317-0146)	異形風暴 (set 1, 日本版, 2 Players, FD1094 317-0146)	Sega
shdancer	影舞者 (set 3, 美國版)	影舞者 (set 3, 美國版)	Sega
shdancej	影舞者 (set 2, 日本版)	影舞者 (set 2, 日本版)	Sega
shdance1	影舞者 (set 1)	影舞者 (set 1)	Sega
cltchitr	日本職棒 (set 2, 美國版, FD1094 317-0176)	日本職棒 (set 2, 美國版, FD1094 317-0176)	Sega
cltchtrj	日本職棒 (set 1, 日本版, FD1094 317-0175)	日本職棒 (set 1, 日本版, FD1094 317-0175)	Sega
mwalk	外星戰將 (set 3, 世界版, FD1094/8751 317-0159)	外星戰將 (set 3, 世界版, FD1094/8751 317-0159)	Sega
mwalku	外星戰將 (set 2, 美國版, FD1094/8751 317-0158)	外星戰將 (set 2, 美國版, FD1094/8751 317-0158)	Sega
mwalkj	外星戰將 (set 1, 日本版, FD1094/8751 317-0157)	外星戰將 (set 1, 日本版, FD1094/8751 317-0157)	Sega
astormbl	異形風暴 (盜版)	異形風暴 (盜版)	bootleg
shdancbl	影之舞 (盜版)	影之舞 (盜版)	bootleg
mwalkbl	外星戰將 (盜版)	外星戰將 (盜版)	bootleg
aburner	衝破火網 (日本版)	衝破火網 (日本版)	Sega
aburner2	衝破火網 II	衝破火網 II	Sega
loffire	爆彈野狼 (世界版, FD1094 317-0136)	爆彈野狼 (世界版, FD1094 317-0136)	Sega
loffireu	爆彈野狼 (美國版, FD1094 317-0135)	爆彈野狼 (美國版, FD1094 317-0135)	Sega
loffirej	爆彈野狼 (日本版, FD1094 317-0134)	爆彈野狼 (日本版, FD1094 317-0134)	Sega
alien3	異形 3: The Gun (世界版)	異形 3: The Gun (世界版)	Sega
alien3u	異形 3: The Gun (美國版)	異形 3: The Gun (美國版)	Sega
sonic	SEGA 音速小子 (日本版, rev. C)	SEGA 音速小子 (日本版, rev. C)	Sega
sonicp	SEGA 音速小子 (日本版, 開發版)	SEGA 音速小子 (日本版, 開發版)	Sega
jpark	侏儸紀公園	侏儸紀公園	Sega
ga2	戰斧二 / 戰斧: 帝王的復仇 (世界版)	戰斧二 / 戰斧: 帝王的復仇 (世界版)	Sega
ga2u	戰斧二 / 戰斧: 帝王的復仇 (美國版)	戰斧二 / 戰斧: 帝王的復仇 (美國版)	Sega
ga2j	戰斧二 / 戰斧: 帝王的復仇 (日本版)	戰斧二 / 戰斧: 帝王的復仇 (日本版)	Sega
spidman	蜘蛛人 (世界版)	蜘蛛人 (世界版)	Sega
spidmanu	蜘蛛人 (美國版)	蜘蛛人 (美國版)	Sega
arabfgt	阿拉丁神燈 (世界版)	阿拉丁神燈 (世界版)	Sega
arabfgtu	阿拉丁神燈 (美國版)	阿拉丁神燈 (美國版)	Sega
arabfgtj	阿拉丁神燈 (日本版)	阿拉丁神燈 (日本版)	Sega
dbzvrvs	七龍珠 Z V.R.V.S.	七龍珠 Z V.R.V.S.	Sega / Banpresto
vf	VR 快打	VR 快打	Sega
vr	VR 賽車	VR 賽車	Sega
vformula	VR 賽車 / Virtua Formula	VR 賽車 / Virtua Formula	Sega
swa	星際大戰 Arcade	星際大戰 Arcade	Sega
wingwar	飛行戰爭 (美國版)	飛行戰爭 (美國版)	Sega
wingwara	飛行戰爭	飛行戰爭	Sega
bakubaku	動物方塊 - 世界飼育係選手權 (J 950407 V1.000)	動物方塊 - 世界飼育係選手權 (J 950407 V1.000)	Sega
colmns97	寶石方塊 '97 (JET 961209 V1.000)	寶石方塊 '97 (JET 961209 V1.000)	Sega
cotton2	小魔女 2 (JUET 970902 V1.000)	小魔女 2 (JUET 970902 V1.000)	Success
cottonbm	小魔女 - 小組隊 (JUET 980709 V1.000)	小魔女 - 小組隊 (JUET 980709 V1.000)	Success
decathlt	十項全能 (JUET 960424 V1.000)	十項全能 (JUET 960424 V1.000)	Sega
diehard	火爆刑事 / Die Hard Arcade (UET 960515 V1.000)	火爆刑事 / Die Hard Arcade (UET 960515 V1.000)	Sega
dnmtdeka	火爆刑事 (J 960515 V1.000)	火爆刑事 (J 960515 V1.000)	Sega
ejihon	偵探事務所 (J 950613 V1.000)	偵探事務所 (J 950613 V1.000)	Sega
elandore	鬥龍傳說 (JUET 980922 V1.006)	鬥龍傳說 (JUET 980922 V1.006)	Sai-Mate
ffreveng	街頭快打格鬥版 (JUET 990714 V1.000)	街頭快打格鬥版 (JUET 990714 V1.000)	Capcom
findlove	全國制服美少女 Find Love (J 971212 V1.000)	全國制服美少女 Find Love (J 971212 V1.000)	Daiki / FCF
finlarch	超級大聯盟 / Final Arch (J 950714 V1.001)	超級大聯盟 / Final Arch (J 950714 V1.001)	Sega
gaxeduel	戰斧格鬥版 (JUETL 950117 V1.000)	戰斧格鬥版 (JUETL 950117 V1.000)	Sega
grdforce	坦克風暴 (JUET 980318 V0.105)	坦克風暴 (JUET 980318 V0.105)	Success
groovef	豪血寺一族 3 (J 970416 V1.001)	豪血寺一族 3 (J 970416 V1.001)	Atlus
hanagumi	櫻花大戰 - 寶石方塊 (J 971007 V1.010)	櫻花大戰 - 寶石方塊 (J 971007 V1.010)	Sega
kiwames	職業麻雀 極 S (J 951020 V1.208) 	職業麻雀 極 S (J 951020 V1.208) 	Athena
myfairld	VR 麻雀 2 - 窈窕淑女 (J 980608 V1.000)	VR 麻雀 2 - 窈窕淑女 (J 980608 V1.000)	Micronet
othellos	奧賽羅黑白棋 (J 980423 V1.002)	奧賽羅黑白棋 (J 980423 V1.002)	Success
rsgun	閃亮銀槍 (JUET 980523 V1.000)	閃亮銀槍 (JUET 980523 V1.000)	Treasure
seabass	釣魚專家 (JUET 971110 V0.001)	釣魚專家 (JUET 971110 V0.001)	A wave inc. (Able license)
shanhigw	上海 - 萬里長城 (JUE 950623 V1.005)	上海 - 萬里長城 (JUE 950623 V1.005)	Sunsoft / Activision
shienryu	紫炎龍 (JUET 961226 V1.000)	紫炎龍 (JUET 961226 V1.000)	Warashi
smleague	超級大聯盟 (U 960108 V1.000)	超級大聯盟 (U 960108 V1.000)	Sega
sokyugrt	蒼穹紅蓮隊 (JUET 960821 V1.000)	蒼穹紅蓮隊 (JUET 960821 V1.000)	Raizing / 8ing
suikoenb	水滸演武 (J 950314 V2.001)	水滸演武 (J 950314 V2.001)	Data East
twcup98	Tecmo 世界盃足球 '98 (JUET 980410 V1.000)	Tecmo 世界盃足球 '98 (JUET 980410 V1.000)	Tecmo
vfkids	VR 少年快打 (JUET 960319 V0.000)	VR 少年快打 (JUET 960319 V0.000)	Sega
vfremix	VR 快打 Remix (JUETBKAL 950428 V1.000)	VR 快打 Remix (JUETBKAL 950428 V1.000)	Sega
vmahjong	VR 麻雀 (J 961214 V1.000)	VR 麻雀 (J 961214 V1.000)	Micronet
batmanfr	永遠的蝙蝠俠 (JUE 960507 V1.000)	永遠的蝙蝠俠 (JUE 960507 V1.000)	Acclaim
sfish2	釣魚機 2 (UET 951106 V1.10e)	釣魚機 2 (UET 951106 V1.10e)	Sega
sfish2j	釣魚機 2 (J 951201 V1.100)	釣魚機 2 (J 951201 V1.100)	Sega
daytona	雷特娜賽車 (日本版)	雷特娜賽車 (日本版)	Sega
daytonat	雷特娜賽車 (日本版, Turbo hack)	雷特娜賽車 (日本版, Turbo hack)	Sega
daytonam	雷特娜賽車 (日本版, To The MAXX)	雷特娜賽車 (日本版, To The MAXX)	Sega
desert	沙漠坦克	沙漠坦克	Sega/Martin Marietta
vcop	VR 戰警	VR 戰警	Sega
manxtt	曼島 TT 超級機車賽	曼島 TT 超級機車賽	Sega
srallyc	SEGA 越野賽車冠軍盃	SEGA 越野賽車冠軍盃	Sega
vf2	VR 快打 2 (ver 2.1)	VR 快打 2 (ver 2.1)	Sega
vf2b	VR 快打 2 (ver B)	VR 快打 2 (ver B)	Sega
vf2o	VR 快打 2 (original)	VR 快打 2 (original)	Sega
vcop2	VR 戰警 2	VR 戰警 2	Sega
dynamcop	火爆刑事 2 / Dynamite Cop (Model 2A)	火爆刑事 2 / Dynamite Cop (Model 2A)	Sega
dyndeka2	火爆刑事 2 (日本版, Model 2A)	火爆刑事 2 (日本版, Model 2A)	Sega
doaa	生死格鬥 (Model 2A)	生死格鬥 (Model 2A)	Sega
zeroguna	零式戰機 (Model 2A)	零式戰機 (Model 2A)	Psikyo
vstriker	VR 足球	VR 足球	Sega
vstrikra	VR 足球 (Rev A)	VR 足球 (Rev A)	Sega
fvipers	毒蛇格鬥	毒蛇格鬥	Sega
gunblade	紐約槍戰	紐約槍戰	Sega
indy500	印第安納波里 500 英哩大賽車	印第安納波里 500 英哩大賽車	Sega
skytargt	威天神鷹	威天神鷹	Sega
dynmcopb	火爆刑事 2 / Dynamite Cop (Model 2B)	火爆刑事 2 / Dynamite Cop (Model 2B)	Sega
schamp	音速小子格鬥	音速小子格鬥	Sega
lastbrnx	東京番外地 (Export, Rev A)	東京番外地 (Export, Rev A)	Sega
lastbrnj	東京番外地 (日本版, Rev A)	東京番外地 (日本版, Rev A)	Sega
doa	生死格鬥 (Model 2B)	生死格鬥 (Model 2B)	Sega
sgt24h	超級 GT 24h	超級 GT 24h	Jaleco
von	電腦戰機 (日本版)	電腦戰機 (日本版)	Sega
vonusa	電腦戰機 / Virtual On Cyber Troopers (美國版)	電腦戰機 / Virtual On Cyber Troopers (美國版)	Sega
dynabb	火爆職棒 '97	火爆職棒 '97	Sega
zerogun	零式戰機 (Model 2B)	零式戰機 (Model 2B)	Psikyo
zerogunj	零式戰機 (日本版 Model 2B)	零式戰機 (日本版 Model 2B)	Psikyo
skisuprg	SEGA 滑雪機 Super G	SEGA 滑雪機 Super G	Sega
stcc	SEGA 房車錦標賽	SEGA 房車錦標賽	Sega
hotd	死亡鬼屋	死亡鬼屋	Sega
topskatr	滑板機	滑板機	Sega
bel	衝出封鎖線	衝出封鎖線	Sega/EPL Productions
vf3	VR 快打 3	VR 快打 3	Sega
vf3tb	VR 快打 3 TB	VR 快打 3 TB	Sega
bass	SEGA 釣魚大賽	SEGA 釣魚大賽	Sega
getbass	SEGA 釣魚大賽 / Get Bass	SEGA 釣魚大賽 / Get Bass	Sega
scud	超級賽車 (澳洲版)	超級賽車 (澳洲版)	Sega
scuda	超級賽車 (Export)	超級賽車 (Export)	Sega
scudp	超級賽車 Plus	超級賽車 Plus	Sega
lostwsga	失落的世界 - 侏儸紀公園	失落的世界 - 侏儸紀公園	Sega
vs215	VR 足球 2 (Step 1.5)	VR 足球 2 (Step 1.5)	Sega
lemans24	利曼 24 小時耐久賽	利曼 24 小時耐久賽	Sega
vs29815	VR 足球 2 '98 (Step 1.5)	VR 足球 2 '98 (Step 1.5)	Sega
vs2	VR 足球 2 (Step 2.0)	VR 足球 2 (Step 2.0)	Sega
harley	哈雷騎士	哈雷騎士	Sega
srally2	SEGA 越野賽車 2	SEGA 越野賽車 2	Sega
sraly2dx	SEGA 越野賽車 2 DX	SEGA 越野賽車 2 DX	Sega
von2	電腦戰機 2	電腦戰機 2	Sega
von254g	電腦戰機 2 (ver 5.4g)	電腦戰機 2 (ver 5.4g)	Sega
fvipers2	毒蛇格鬥 2	毒蛇格鬥 2	Sega
vs298	VR 足球 2 '98 (Step 2.0)	VR 足球 2 '98 (Step 2.0)	Sega
vs2v991	VR 足球 2 '99.1	VR 足球 2 '99.1	Sega
vs299	VR 足球 2 '99	VR 足球 2 '99	Sega
daytona2	雷特娜賽車 2	雷特娜賽車 2	Sega
dayto2pe	雷特娜賽車 2 POWER EDITION	雷特娜賽車 2 POWER EDITION	Sega
dirtdvls	越野障礙賽	越野障礙賽	Sega
dirtdvla	越野障礙賽 (alt)	越野障礙賽 (alt)	Sega
swtrilgy	星際大戰三部曲 (ver A)	星際大戰三部曲 (ver A)	Sega/LucasArts
swtrilga	星際大戰三部曲	星際大戰三部曲	Sega/LucasArts
spikeout	致命一擊	致命一擊	Sega
spikeofe	致命一擊 FINAL EDITION	致命一擊 FINAL EDITION	Sega
eca	救急車	救急車	Sega
karianx	魔法寶石 / Karian Cross (Rev. 1.0)	魔法寶石 / Karian Cross (Rev. 1.0)	Deniam
columns	寶石方塊 (世界版)	寶石方塊 (世界版)	Sega
columnsu	寶石方塊 (美國版, 檯面型)	寶石方塊 (美國版, 檯面型)	Sega
columnsj	寶石方塊 (日本版)	寶石方塊 (日本版)	Sega
columns2	寶石方塊 II: The Voyage Through Time (世界版)	寶石方塊 II: The Voyage Through Time (世界版)	Sega
column2j	寶石方塊 II: The Voyage Through Time (日本版)	寶石方塊 II: The Voyage Through Time (日本版)	Sega
tfrceac	雷霆力量 AC	雷霆力量 AC	Sega / Technosoft
tfrceacj	雷霆力量 AC (日本版)	雷霆力量 AC (日本版)	Sega / Technosoft
tfrceacb	雷霆力量 AC (盜版)	雷霆力量 AC (盜版)	bootleg
ribbit	蝦墓之園 / Ribbit!	蝦墓之園 / Ribbit!	Sega
puckpkmn	小精靈與皮卡丘	小精靈與皮卡丘	Genie
mt_beast	獸王記 / Altered Beast (Mega-Tech)	獸王記 / Altered Beast (Mega-Tech)	Sega
mt_aftrb	衝破火網 (Mega-Tech)	衝破火網 (Mega-Tech)	Sega
mt_lastb	北斗之拳 - 新世紀末救世主傳說 (Mega-Tech)	北斗之拳 - 新世紀末救世主傳說 (Mega-Tech)	Sega
mt_tetri	俄羅斯方塊 (Mega-Tech)	俄羅斯方塊 (Mega-Tech)	Sega
mt_gng	大魔界村 / Ghouls'n Ghosts (Mega-Tech)	大魔界村 / Ghouls'n Ghosts (Mega-Tech)	Capcom / Sega
mt_gaxe	戰斧 (Mega-Tech)	戰斧 (Mega-Tech)	Sega
mt_mystd	孔雀王 2 - 幻影城 / Mystic Defender (Mega-Tech)	孔雀王 2 - 幻影城 / Mystic Defender (Mega-Tech)	Sega
mt_cols	寶石方塊 (Mega-Tech)	寶石方塊 (Mega-Tech)	Sega
mt_mwalk	外星戰將 (Mega-Tech)	外星戰將 (Mega-Tech)	Sega
mt_sonic	音速小子 (Mega-Tech, set 1)	音速小子 (Mega-Tech, set 1)	Sega
mt_sonia	音速小子 (Mega-Tech, set 2)	音速小子 (Mega-Tech, set 2)	Sega
mt_fshrk	鮫! 鮫! 鮫! / Fire Shark (Mega-Tech)	鮫! 鮫! 鮫! / Fire Shark (Mega-Tech)	Toaplan / Sega
mt_gaxe2	戰斧 II (Mega-Tech)	戰斧 II (Mega-Tech)	Sega
mt_soni2	音速小子 2 (Mega-Tech)	音速小子 2 (Mega-Tech)	Sega
mp_sonic	音速小子 (Mega Play)	音速小子 (Mega Play)	Sega
mp_gaxe2	戰斧 II (Mega Play)	戰斧 II (Mega Play)	Sega
mp_twc	Tecmo 世界盃足球 (Mega Play)	Tecmo 世界盃足球 (Mega Play)	Sega
mp_sor2	街頭格鬥 II - 死鬥的鎮魂歌 / Streets of Rage II (Mega Play)	街頭格鬥 II - 死鬥的鎮魂歌 / Streets of Rage II (Mega Play)	Sega
mp_soni2	音速小子 2 (Mega Play)	音速小子 2 (Mega Play)	Sega
mp_col3	寶石方塊 III (Mega Play)	寶石方塊 III (Mega Play)	Sega
zoar	X 任務 / Zoar	X 任務 / Zoar	Data East USA
btime	漢堡王 (Data East set 1)	漢堡王 (Data East set 1)	Data East Corporation
btime2	漢堡王 (Data East set 2)	漢堡王 (Data East set 2)	Data East Corporation
btimem	漢堡王 (Midway)	漢堡王 (Midway)	Data East (Bally Midway license)
cookrace	漢堡王 / Cook Race	漢堡王 / Cook Race	bootleg
wtennis	世界網球	世界網球	bootleg
astrof	宇宙飛行士 (set 1)	宇宙飛行士 (set 1)	Data East
astrof2	宇宙飛行士 (set 2)	宇宙飛行士 (set 2)	Data East
astrof3	宇宙飛行士 (set 3)	宇宙飛行士 (set 3)	Data East
abattle	宇宙飛行士 / Astro Battle (set 1)	宇宙飛行士 / Astro Battle (set 1)	Sidam
abattle2	宇宙飛行士 / Astro Battle (set 2)	宇宙飛行士 / Astro Battle (set 2)	Sidam
afire	宇宙飛行士 / Astro Fire	宇宙飛行士 / Astro Fire	Rene Pierre
acombat	宇宙飛行士 / Astro Combat	宇宙飛行士 / Astro Combat	bootleg
sstarbtl	宇宙飛行士 / Super Star Battle	宇宙飛行士 / Super Star Battle	bootleg
kchamp	空手道 / Karate Champ (美國版)	空手道 / Karate Champ (美國版)	Data East USA
karatedo	空手道 (日本版)	空手道 (日本版)	Data East Corporation
kchampvs	對戰空手道 - 青春美少女篇 / Karate Champ (美國版 VS version)	對戰空手道 - 青春美少女篇 / Karate Champ (美國版 VS version)	Data East USA
karatevs	對戰空手道 - 青春美少女篇 (日本版 VS version)	對戰空手道 - 青春美少女篇 (日本版 VS version)	Data East Corporation
zerotrgt	擊墜王 / Zero Target (世界版)	擊墜王 / Zero Target (世界版)	Data East Corporation
gekitsui	擊墜王 (日本版)	擊墜王 (日本版)	Data East Corporation
firetrap	烈焰陷阱 (美國版)	烈焰陷阱 (美國版)	Data East USA
firetpbl	烈焰陷阱 (日本版 盜版)	烈焰陷阱 (日本版 盜版)	bootleg
brkthru	強行突破 / Break Thru (美國版)	強行突破 / Break Thru (美國版)	Data East USA
brkthruj	強行突破 (日本版)	強行突破 (日本版)	Data East Corporation
forcebrk	強行突破 / Force Break (盜版)	強行突破 / Force Break (盜版)	bootleg
darwin	達爾文戰機 4078 (日本版)	達爾文戰機 4078 (日本版)	Data East Corporation
shootout	神槍手 (美國版)	神槍手 (美國版)	Data East USA
shootouj	神槍手 (日本版)	神槍手 (日本版)	Data East USA
shootoub	神槍手 (韓文 盜版)	神槍手 (韓文 盜版)	bootleg
exprraid	火車大盜 / Express Raider (美國版)	火車大盜 / Express Raider (美國版)	Data East USA
exprrada	火車大盜 / Express Raider (美國版 set 2)	火車大盜 / Express Raider (美國版 set 2)	Data East USA
wexpress	火車大盜 (世界版?)	火車大盜 (世界版?)	Data East Corporation
wexpresb	火車大盜 (盜版 set 1)	火車大盜 (盜版 set 1)	bootleg
wexpresc	火車大盜 (盜版 set 2)	火車大盜 (盜版 set 2)	bootleg
pcktgal	撞球 (日本版)	撞球 (日本版)	Data East Corporation
pcktgalb	撞球 (盜版)	撞球 (盜版)	bootleg
pcktgal2	撞球 2 (世界版?)	撞球 2 (世界版?)	Data East Corporation
spool3	撞球 / Super Pool III (世界版?)	撞球 / Super Pool III (世界版?)	Data East Corporation
spool3i	撞球 / Super Pool III (I-Vics)	撞球 / Super Pool III (I-Vics)	Data East Corporation (I-Vics license)
battlera	流氓戰鬥部隊 嗜血野狼 / Battle Rangers (世界版)	流氓戰鬥部隊 嗜血野狼 / Battle Rangers (世界版)	Data East Corporation
bldwolf	流氓戰鬥部隊 嗜血野狼 / Bloody Wolf (美國版)	流氓戰鬥部隊 嗜血野狼 / Bloody Wolf (美國版)	Data East USA
lastmisn	最終任務 (美國版 revision 6)	最終任務 (美國版 revision 6)	Data East USA
lastmsno	最終任務 (美國版 revision 5)	最終任務 (美國版 revision 5)	Data East USA
lastmsnj	最終任務 (日本版)	最終任務 (日本版)	Data East Corporation
ghostb	迷宮獵人 G / The Real Ghostbusters (美國版 2 Players)	迷宮獵人 G / The Real Ghostbusters (美國版 2 Players)	Data East USA
ghostb3	迷宮獵人 G / The Real Ghostbusters (美國版 3 Players)	迷宮獵人 G / The Real Ghostbusters (美國版 3 Players)	Data East USA
meikyuh	迷宮獵人 G (日本版)	迷宮獵人 G (日本版)	Data East Corporation
srdarwin	SRD 超級達爾文戰機 (世界版)	SRD 超級達爾文戰機 (世界版)	Data East Corporation
srdarwnj	SRD 超級達爾文戰機 (日本版)	SRD 超級達爾文戰機 (日本版)	Data East Corporation
gondo	魔境戰士 / Gondomania (美國版)	魔境戰士 / Gondomania (美國版)	Data East USA
makyosen	魔境戰士 (日本版)	魔境戰士 (日本版)	Data East Corporation
garyoret	臥龍列傳 (日本版)	臥龍列傳 (日本版)	Data East Corporation
cobracom	眼睛蛇指令 (世界版 revision 5)	眼睛蛇指令 (世界版 revision 5)	Data East Corporation
cobracmj	眼睛蛇指令 (日本版)	眼睛蛇指令 (日本版)	Data East Corporation
karnov	格鬥列傳 (美國版)	格鬥列傳 (美國版)	Data East USA
karnovj	格鬥列傳 (日本版)	格鬥列傳 (日本版)	Data East Corporation
wndrplnt	神奇星球 (日本版)	神奇星球 (日本版)	Data East Corporation
chelnov	原子超人 (世界版)	原子超人 (世界版)	Data East Corporation
chelnovu	原子超人 (美國版)	原子超人 (美國版)	Data East USA
chelnovj	原子超人 (日本版)	原子超人 (日本版)	Data East Corporation
baddudes	龍之忍者 / Bad Dudes vs. Dragonninja (美國版)	龍之忍者 / Bad Dudes vs. Dragonninja (美國版)	Data East USA
drgninja	龍之忍者 (日本版)	龍之忍者 (日本版)	Data East Corporation
robocop	機械戰警 (世界版 revision 4)	機械戰警 (世界版 revision 4)	Data East Corporation
robocopw	機器戰警 (世界版 revision 3)	機器戰警 (世界版 revision 3)	Data East Corporation
robocopj	機器戰警 (日本版)	機器戰警 (日本版)	Data East Corporation
robocopu	機器戰警 (美國版 revision 1)	機器戰警 (美國版 revision 1)	Data East USA
robocpu0	機器戰警 (美國版 revision 0)	機器戰警 (美國版 revision 0)	Data East USA
robocopb	機器戰警 (世界版 盜版)	機器戰警 (世界版 盜版)	bootleg
hippodrm	競技場 - 激鬥幻想 / Hippodrome (美國版)	競技場 - 激鬥幻想 / Hippodrome (美國版)	Data East USA
ffantasy	競技場 - 激鬥幻想 (日本版 revision 2)	競技場 - 激鬥幻想 (日本版 revision 2)	Data East Corporation
ffantasa	競技場 - 激鬥幻想 (日本版)	競技場 - 激鬥幻想 (日本版)	Data East Corporation
midres	午夜逆襲 (世界版)	午夜逆襲 (世界版)	Data East Corporation
midresu	午夜逆襲 (美國版)	午夜逆襲 (美國版)	Data East USA
midresj	午夜逆襲 (日本版)	午夜逆襲 (日本版)	Data East Corporation
madmotor	瘋狂摩托車	瘋狂摩托車	Mitchell
vaportra	空牙 / Vapor Trail - Hyper Offence Formation (世界版 revision 1)	空牙 / Vapor Trail - Hyper Offence Formation (世界版 revision 1)	Data East Corporation
vaportru	空牙 / Vapor Trail - Hyper Offence Formation (美國版)	空牙 / Vapor Trail - Hyper Offence Formation (美國版)	Data East USA
kuhga	空牙 (日本版 revision 3)	空牙 (日本版 revision 3)	Data East Corporation
cbuster	暴力剋星 (世界版 FX version)	暴力剋星 (世界版 FX version)	Data East Corporation
cbusterw	暴力剋星 (世界版 FU version)	暴力剋星 (世界版 FU version)	Data East Corporation
cbusterj	暴力剋星 (日本版)	暴力剋星 (日本版)	Data East Corporation
twocrude	暴力剋星 / Two Crude (美國版)	暴力剋星 / Two Crude (美國版)	Data East USA
darkseal	黑暗封印 (世界版 revision 3)	黑暗封印 (世界版 revision 3)	Data East Corporation
darksea1	黑暗封印 (世界版 revision 1)	黑暗封印 (世界版 revision 1)	Data East Corporation
darkseaj	黑暗封印 (日本版)	黑暗封印 (日本版)	Data East Corporation
gatedoom	黑暗封印 / 毀滅之門 (美國版 revision 4)	黑暗封印 / 毀滅之門 (美國版 revision 4)	Data East Corporation
gatedom1	黑暗封印 / 毀滅之門 (美國版 revision 1)	黑暗封印 / 毀滅之門 (美國版 revision 1)	Data East Corporation
cninja	戰鬥原始人 / Caveman Ninja (世界版 revision 3)	戰鬥原始人 / Caveman Ninja (世界版 revision 3)	Data East Corporation
cninja0	戰鬥原始人 / Caveman Ninja (世界版 revision 0)	戰鬥原始人 / Caveman Ninja (世界版 revision 0)	Data East Corporation
cninjau	戰鬥原始人 / Caveman Ninja (美國版)	戰鬥原始人 / Caveman Ninja (美國版)	Data East Corporation
joemac	戰鬥原始人 (日本版)	戰鬥原始人 (日本版)	Data East Corporation
stoneage	戰鬥原始人 / Stoneage	戰鬥原始人 / Stoneage	bootleg
robocop2	機器戰警 2 (歐洲版/亞洲版 v0.10)	機器戰警 2 (歐洲版/亞洲版 v0.10)	Data East Corporation
robocp2u	機器戰警 2 (美國版 v0.05)	機器戰警 2 (美國版 v0.05)	Data East Corporation
robocp2j	機器戰警 2 (日本版 v0.11)	機器戰警 2 (日本版 v0.11)	Data East Corporation
chinatwn	唐人街 (日本版)	唐人街 (日本版)	Data East Corporation
rohga	狼牙 - 空牙 2001 / Rohga Armor Force (亞洲版/歐洲版 v5.0)	狼牙 - 空牙 2001 / Rohga Armor Force (亞洲版/歐洲版 v5.0)	Data East Corporation
rohga1	狼牙 - 空牙 2001 / Rohga Armor Force (亞洲版/歐洲版 v3.0 Set 1)	狼牙 - 空牙 2001 / Rohga Armor Force (亞洲版/歐洲版 v3.0 Set 1)	Data East Corporation
rohga2	狼牙 - 空牙 2001 / Rohga Armor Force (亞洲版/歐洲版 v3.0 Set 2)	狼牙 - 空牙 2001 / Rohga Armor Force (亞洲版/歐洲版 v3.0 Set 2)	Data East Corporation
rohgah	狼牙 - 空牙 2001 / Rohga Armor Force (香港版 v3.0)	狼牙 - 空牙 2001 / Rohga Armor Force (香港版 v3.0)	Data East Corporation
rohgau	狼牙 - 空牙 2001 / Rohga Armor Force (美國版 v1.0)	狼牙 - 空牙 2001 / Rohga Armor Force (美國版 v1.0)	Data East Corporation
captaven	美國隊長 (亞洲版 Rev 1.9)	美國隊長 (亞洲版 Rev 1.9)	Data East Corporation
captavna	美國隊長 (亞洲版 Rev 1.0)	美國隊長 (亞洲版 Rev 1.0)	Data East Corporation
captavne	美國隊長 (英國版 Rev 1.4)	美國隊長 (英國版 Rev 1.4)	Data East Corporation
captavnu	美國隊長 (美國版 Rev 1.9)	美國隊長 (美國版 Rev 1.9)	Data East Corporation
captavuu	美國隊長 (美國版 Rev 1.6)	美國隊長 (美國版 Rev 1.6)	Data East Corporation
captavnj	美國隊長 (日本版 Rev 0.2)	美國隊長 (日本版 Rev 0.2)	Data East Corporation
tumblep	捉鬼大師 (世界版)	捉鬼大師 (世界版)	Data East Corporation
tumblepj	捉鬼大師 (日本版)	捉鬼大師 (日本版)	Data East Corporation
tumbleb	捉鬼大師 (盜版 set 1)	捉鬼大師 (盜版 set 1)	bootleg
tumbleb2	捉鬼大師 (盜版 set 2)	捉鬼大師 (盜版 set 2)	bootleg
semibase	無限勝負 (SemiCom Baseball)	無限勝負 (SemiCom Baseball)	SemiCom
dblewing	雙翼	雙翼	Mitchell
nslasher	午夜殺生 (韓國版 Rev 1.3)	午夜殺生 (韓國版 Rev 1.3)	Data East Corporation
nslashej	午夜殺生 (日本版 Rev 1.2)	午夜殺生 (日本版 Rev 1.2)	Data East Corporation
nslashes	午夜殺生 (Over Sea Rev 1.2)	午夜殺生 (Over Sea Rev 1.2)	Data East Corporation
sotsugyo	卒業證書	卒業證書	Mitchell (Atlus license)
sshangha	超級上海 (日本版)	超級上海 (日本版)	Hot-B.
sshanghb	超級上海 (世界版, 盜版)	超級上海 (世界版, 盜版)	bootleg
skullfng	空牙外傳 (日本版)	空牙外傳 (日本版)	Data East Corporation
starforc	星際武力	星際武力	Tehkan
starfore	星際武力 (加密)	星際武力 (加密)	Tehkan
megaforc	星際武力	星際武力	Tehkan (Video Ware license)
bombjack	炸彈傑克 (set 1)	炸彈傑克 (set 1)	Tehkan
bombjac2	炸彈傑克 (set 2)	炸彈傑克 (set 2)	Tehkan
solomon	所羅門之鑰 (日本版)	所羅門之鑰 (日本版)	Tecmo
rygar	未來戰士 / Rygar (美國版 set 1)	未來戰士 / Rygar (美國版 set 1)	Tecmo
rygar2	未來戰士 / Rygar (美國版 set 2)	未來戰士 / Rygar (美國版 set 2)	Tecmo
rygarj	未來戰士 (日本版)	未來戰士 (日本版)	Tecmo
gemini	雙子星	雙子星	Tecmo
silkworm	聯合作戰 (set 1)	聯合作戰 (set 1)	Tecmo
silkwrm2	聯合作戰 (set 2)	聯合作戰 (set 2)	Tecmo
shadoww	忍者龍劍傳 / Shadow Warriors (世界版 set 1)	忍者龍劍傳 / Shadow Warriors (世界版 set 1)	Tecmo
shadowwa	忍者龍劍傳 / Shadow Warriors (世界版 set 2)	忍者龍劍傳 / Shadow Warriors (世界版 set 2)	Tecmo
gaiden	忍者龍劍傳 / Ninja Gaiden (美國版)	忍者龍劍傳 / Ninja Gaiden (美國版)	Tecmo
ryukendn	忍者龍劍傳 (日本版)	忍者龍劍傳 (日本版)	Tecmo
stratof	雷牙 (美國版)	雷牙 (美國版)	Tecmo
raiga	雷牙 (日本版)	雷牙 (日本版)	Tecmo
wc90	Tecmo 世界盃足球 '90 (set 1)	Tecmo 世界盃足球 '90 (set 1)	Tecmo
wc90a	Tecmo 世界盃足球 '90 (set 2)	Tecmo 世界盃足球 '90 (set 2)	Tecmo
wc90t	Tecmo 世界盃足球 '90 (軌跡球)	Tecmo 世界盃足球 '90 (軌跡球)	Tecmo
wc90b	Tecmo 世界盃足球 '90 / Euro League	Tecmo 世界盃足球 '90 / Euro League	bootleg
fstarfrc	最終星際武力 (美國版)	最終星際武力 (美國版)	Tecmo
tkdensho	鬥姬傳承 -Angel Eyes-	鬥姬傳承 -Angel Eyes-	Tecmo
psurge	電路小精靈	電路小精靈	<unknown>
pandoras	潘朵拉之殿	潘朵拉之殿	Konami/Interlogic
hyperspt	科拿米運動會 '84 / Hyper Sports	科拿米運動會 '84 / Hyper Sports	Konami (Centuri license)
hpolym84	科拿米運動會 '84	科拿米運動會 '84	Konami
sbasketb	超級籃球 (version G)	超級籃球 (version G)	Konami
sbasketo	超級籃球 (version E)	超級籃球 (version E)	Konami
sbasketu	超級籃球 (未加密)	超級籃球 (未加密)	Konami
mikie	新入社員 / Mikie	新入社員 / Mikie	Konami
mikiej	新入社員	新入社員	Konami
mikiehs	新入社員 / Mikie (High School Graffiti)	新入社員 / Mikie (High School Graffiti)	Konami
yiear	功夫 (set 1)	功夫 (set 1)	Konami
yiear2	功夫 (set 2)	功夫 (set 2)	Konami
kicker	少林寺之道 / Kicker	少林寺之道 / Kicker	Konami
shaolins	少林寺之道 / Shao-Lin's Road	少林寺之道 / Shao-Lin's Road	Konami
pingpong	乒乓球	乒乓球	Konami
gberet	綠色兵團	綠色兵團	Konami
rushatck	綠色兵團 / Rush'n Attack (美國版)	綠色兵團 / Rush'n Attack (美國版)	Konami
gberetb	綠色兵團 (盜版)	綠色兵團 (盜版)	bootleg
mrgoemon	大盜五右衛門 (日本版)	大盜五右衛門 (日本版)	Konami
ironhors	火車大盜 / Iron Horse	火車大盜 / Iron Horse	Konami
dairesya	火車大盜 (日本版)	火車大盜 (日本版)	[Konami] (Kawakusu license)
farwest	火車大盜 / Far West	火車大盜 / Far West	bootleg?
jackal	特種部隊 豺 / Jackal (世界版)	特種部隊 豺 / Jackal (世界版)	Konami
topgunr	特種部隊 豺 / Top Gunner (美國版)	特種部隊 豺 / Top Gunner (美國版)	Konami
jackalj	特種部隊 豺 (日本版)	特種部隊 豺 (日本版)	Konami
topgunbl	特種部隊 豺 / Top Gunner (盜版)	特種部隊 豺 / Top Gunner (盜版)	bootleg
contra	魂斗羅 / Contra (美國版)	魂斗羅 / Contra (美國版)	Konami
contrab	魂斗羅 / Contra (美國版 盜版)	魂斗羅 / Contra (美國版 盜版)	bootleg
contraj	魂斗羅 (日本版)	魂斗羅 (日本版)	Konami
contrajb	魂斗羅 (日本版 盜版)	魂斗羅 (日本版 盜版)	bootleg
gryzor	魂斗羅 / Gryzor	魂斗羅 / Gryzor	Konami
rockrage	戀愛熱搖滾 / Rock 'n Rage (世界版?)	戀愛熱搖滾 / Rock 'n Rage (世界版?)	Konami
rockraga	戀愛熱搖滾 / Rock 'n Rage (開發版?)	戀愛熱搖滾 / Rock 'n Rage (開發版?)	Konami
rockragj	戀愛熱搖滾 (日本版)	戀愛熱搖滾 (日本版)	Konami
hcastle	惡魔城 / Haunted Castle (version M)	惡魔城 / Haunted Castle (version M)	Konami
hcastleo	惡魔城 / Haunted Castle (version K)	惡魔城 / Haunted Castle (version K)	Konami
hcastlej	惡魔城 (日本版 version P)	惡魔城 (日本版 version P)	Konami
hcastljo	惡魔城 (日本版 version N)	惡魔城 (日本版 version N)	Konami
ajax	A-JAX 颶風直升機	A-JAX 颶風直升機	Konami
typhoon	A-JAX 颶風直升機 / Typhoon	A-JAX 颶風直升機 / Typhoon	Konami
ajaxj	A-JAX 颶風直升機 (日本版)	A-JAX 颶風直升機 (日本版)	Konami
scontra	超級魂斗羅	超級魂斗羅	Konami
scontraj	超級魂斗羅 (日本版)	超級魂斗羅 (日本版)	Konami
thunderx	雷霆戰機	雷霆戰機	Konami
thnderxa	雷霆戰機 (Set 2)	雷霆戰機 (Set 2)	Konami
thnderxb	雷霆戰機 (Set 3)	雷霆戰機 (Set 3)	Konami
thnderxj	雷霆戰機 (日本版)	雷霆戰機 (日本版)	Konami
devstors	餓流禍 / Devastators (ver. Z)	餓流禍 / Devastators (ver. Z)	Konami
devstor2	餓流禍 / Devastators (ver. X)	餓流禍 / Devastators (ver. X)	Konami
devstor3	餓流禍 / Devastators (ver. V)	餓流禍 / Devastators (ver. V)	Konami
garuka	餓流禍 (日本版 ver. W)	餓流禍 (日本版 ver. W)	Konami
88games	科拿米運動會 '88 / '88 Games	科拿米運動會 '88 / '88 Games	Konami
konami88	科拿米運動會 '88 / Konami '88	科拿米運動會 '88 / Konami '88	Konami
hypsptsp	科拿米運動會 '88 (日本版)	科拿米運動會 '88 (日本版)	Konami
gbusters	瘋狂警察 / Gang Busters	瘋狂警察 / Gang Busters	Konami
crazycop	瘋狂警察 (日本版)	瘋狂警察 (日本版)	Konami
crimfght	街頭鬥士 (美國版 4 players)	街頭鬥士 (美國版 4 players)	Konami
crimfgt2	街頭鬥士 (世界版 2 Players)	街頭鬥士 (世界版 2 Players)	Konami
crimfgtj	街頭鬥士 (日本版 2 Players)	街頭鬥士 (日本版 2 Players)	Konami
spy	S.P.Y. - 特別計劃 Y (世界版 ver. N)	S.P.Y. - 特別計劃 Y (世界版 ver. N)	Konami
spyu	S.P.Y. - 特別計劃 Y (美國版 ver. M)	S.P.Y. - 特別計劃 Y (美國版 ver. M)	Konami
aliens	異形 (世界版 set 1)	異形 (世界版 set 1)	Konami
aliens2	異形 (世界版 set 2)	異形 (世界版 set 2)	Konami
aliens3	異形 (世界版 set 3)	異形 (世界版 set 3)	Konami
aliensu	異形 (美國版)	異形 (美國版)	Konami
aliensj	異形 (日本版 set 1)	異形 (日本版 set 1)	Konami
aliensj2	異形 (日本版 set 2)	異形 (日本版 set 2)	Konami
parodius	瘋狂大射擊 DA! (世界版)	瘋狂大射擊 DA! (世界版)	Konami
parodisj	瘋狂大射擊 DA! (日本版)	瘋狂大射擊 DA! (日本版)	Konami
simpsons	辛普森家庭 (4 Players)	辛普森家庭 (4 Players)	Konami
simps4pa	辛普森家庭 (4 Players alt)	辛普森家庭 (4 Players alt)	Konami
simpsn2p	辛普森家庭 (2 Players)	辛普森家庭 (2 Players)	Konami
simps2pa	辛普森家庭 (2 Players alt)	辛普森家庭 (2 Players alt)	Konami
simps2pj	辛普森家庭 (2 Players 日本版)	辛普森家庭 (2 Players 日本版)	Konami
esckids	脫線行大運 (亞洲版, 4 Players)	脫線行大運 (亞洲版, 4 Players)	Konami
esckidsj	脫線行大運 (日本版, 2 Players)	脫線行大運 (日本版, 2 Players)	Konami
vendetta	復仇 2 / Vendetta (世界版 4 Players ver. T)	復仇 2 / Vendetta (世界版 4 Players ver. T)	Konami
vendetao	復仇 2 / Vendetta (世界版 4 Players ver. R)	復仇 2 / Vendetta (世界版 4 Players ver. R)	Konami
vendet2p	復仇 2 / Vendetta (世界版 2 Players ver. W)	復仇 2 / Vendetta (世界版 2 Players ver. W)	Konami
vendetas	復仇 2 / Vendetta (亞洲版 2 Players ver. U)	復仇 2 / Vendetta (亞洲版 2 Players ver. U)	Konami
vendtaso	復仇 2 / Vendetta (亞洲版 2 Players ver. D)	復仇 2 / Vendetta (亞洲版 2 Players ver. D)	Konami
vendettj	復仇 2 (日本版 2 Players ver. P)	復仇 2 (日本版 2 Players ver. P)	Konami
wecleman	WEC 利曼 24 小時耐久賽	WEC 利曼 24 小時耐久賽	Konami
hotchase	追蹤熱擊	追蹤熱擊	Konami
ultraman	鹹蛋超人 (日本版)	鹹蛋超人 (日本版)	Banpresto/Bandai
nemesis	宇宙巡航艦 / 復仇女神	宇宙巡航艦 / 復仇女神	Konami
nemesuk	宇宙巡航艦 / 復仇女神 (世界版?)	宇宙巡航艦 / 復仇女神 (世界版?)	Konami
salamand	沙羅曼蛇 (version D)	沙羅曼蛇 (version D)	Konami
salamanj	沙羅曼蛇 (version J)	沙羅曼蛇 (version J)	Konami
lifefrce	沙羅曼蛇 / Lifeforce (美國版)	沙羅曼蛇 / Lifeforce (美國版)	Konami
lifefrcj	沙羅曼蛇 / Lifeforce (日本版)	沙羅曼蛇 / Lifeforce (日本版)	Konami
twinbee	兵蜂	兵蜂	Konami
gradius	宇宙巡航艦	宇宙巡航艦	Konami
gwarrior	銀河戰士	銀河戰士	Konami
devilw	魔獸王國 / Devil World	魔獸王國 / Devil World	Konami
darkadv	魔獸王國 / Dark Adventure	魔獸王國 / Dark Adventure	Konami
majuu	魔獸王國	魔獸王國	Konami
vulcan	宇宙巡航艦 II / Vulcan Venture	宇宙巡航艦 II / Vulcan Venture	Konami
gradius2	宇宙巡航艦 II (日本版 新版)	宇宙巡航艦 II (日本版 新版)	Konami
grdius2a	宇宙巡航艦 II (日本版 舊版)	宇宙巡航艦 II (日本版 舊版)	Konami
grdius2b	宇宙巡航艦 II (日本版 更舊版)	宇宙巡航艦 II (日本版 更舊版)	Konami
miaj	綠色行動 (日本版)	綠色行動 (日本版)	Konami
mia	綠色行動 (version T)	綠色行動 (version T)	Konami
mia2	綠色行動 (version S)	綠色行動 (version S)	Konami
tmnt	忍者龜 (世界版 4 Players)	忍者龜 (世界版 4 Players)	Konami
tmntu	忍者龜 (美國版 4 Players, set 1)	忍者龜 (美國版 4 Players, set 1)	Konami
tmntua	忍者龜 (美國版 4 Players, set 2)	忍者龜 (美國版 4 Players, set 2)	Konami
tmht	忍者龜 / Teenage Mutant Hero Turtles (英國版 4 Players)	忍者龜 / Teenage Mutant Hero Turtles (英國版 4 Players)	Konami
tmntj	忍者龜 (日本版 4 Players)	忍者龜 (日本版 4 Players)	Konami
tmht2p	忍者龜 / Teenage Mutant Hero Turtles (英國版 2 Players)	忍者龜 / Teenage Mutant Hero Turtles (英國版 2 Players)	Konami
tmnt2pj	忍者龜 (日本版 2 Players)	忍者龜 (日本版 2 Players)	Konami
tmnt2po	忍者龜 (大洋洲版 2 Players)	忍者龜 (大洋洲版 2 Players)	Konami
lgtnfght	火龍 / Lightning Fighters (世界版)	火龍 / Lightning Fighters (世界版)	Konami
lgtnfghu	火龍 / Lightning Fighters (美國版)	火龍 / Lightning Fighters (美國版)	Konami
trigon	火龍 (日本版)	火龍 (日本版)	Konami
blswhstl	出發!! 兵蜂 / Bells & Whistles (Version L)	出發!! 兵蜂 / Bells & Whistles (Version L)	Konami
detatwin	出發!! 兵蜂 (日本版 ver. J)	出發!! 兵蜂 (日本版 ver. J)	Konami
tmnt2	忍者龜 2 - Turtles in Time (4 Players ver UAA)	忍者龜 2 - Turtles in Time (4 Players ver UAA)	Konami
tmnt22p	忍者龜 2 - Turtles in Time (2 Players ver UDA)	忍者龜 2 - Turtles in Time (2 Players ver UDA)	Konami
tmnt2a	忍者龜 2 - Turtles in Time (4 Players ver ADA)	忍者龜 2 - Turtles in Time (4 Players ver ADA)	Konami
ssriders	荒野大鏢客 (4 Players ver EAC)	荒野大鏢客 (4 Players ver EAC)	Konami
ssrdrebd	荒野大鏢客 (2 Players ver EBD)	荒野大鏢客 (2 Players ver EBD)	Konami
ssrdrebc	荒野大鏢客 (2 Players ver EBC)	荒野大鏢客 (2 Players ver EBC)	Konami
ssrdruda	荒野大鏢客 (4 Players ver UDA)	荒野大鏢客 (4 Players ver UDA)	Konami
ssrdreaa	荒野大鏢客 (4 Players ver EAA)	荒野大鏢客 (4 Players ver EAA)	Konami
ssrdruac	荒野大鏢客 (4 Players ver UAC)	荒野大鏢客 (4 Players ver UAC)	Konami
ssrdrubc	荒野大鏢客 (2 Players ver UBC)	荒野大鏢客 (2 Players ver UBC)	Konami
ssrdrabd	荒野大鏢客 (2 Players ver ABD)	荒野大鏢客 (2 Players ver ABD)	Konami
ssrdradd	荒野大鏢客 (4 Players ver ADD)	荒野大鏢客 (4 Players ver ADD)	Konami
ssrdrjbd	荒野大鏢客 (2 Players ver JBD)	荒野大鏢客 (2 Players ver JBD)	Konami
sunsetbl	荒野大鏢客 (盜版 4 Players ver ADD)	荒野大鏢客 (盜版 4 Players ver ADD)	Konami
xmen	X 戰警 (4 Players ver UBB)	X 戰警 (4 Players ver UBB)	Konami
xmen2p	X 戰警 (2 Players ver AAA)	X 戰警 (2 Players ver AAA)	Konami
xmen2pj	X 戰警 (2 Players ver JAA)	X 戰警 (2 Players ver JAA)	Konami
xmen6p	X 戰警 (6 Players ver ECB)	X 戰警 (6 Players ver ECB)	Konami
xmen6pu	X 戰警 (6 Players ver UCB)	X 戰警 (6 Players ver UCB)	Konami
gijoe	特種部隊 (世界版)	特種部隊 (世界版)	Konami
gijoeu	特種部隊 (美國版)	特種部隊 (美國版)	Konami
gijoej	特種部隊 (日本版)	特種部隊 (日本版)	Konami
thndrx2	雷霆戰機 II (日本版)	雷霆戰機 II (日本版)	Konami
thndrx2a	雷霆戰機 II (亞洲版)	雷霆戰機 II (亞洲版)	Konami
prmrsocr	頂級足球 (ver EAB)	頂級足球 (ver EAB)	Konami
prmrsocj	頂級足球 (ver JAB)	頂級足球 (ver JAB)	Konami
gaiapols	黃金鷹之劍 (ver EAF)	黃金鷹之劍 (ver EAF)	Konami
gaiapolu	黃金鷹之劍 (ver UAF)	黃金鷹之劍 (ver UAF)	Konami
gaiapolj	黃金鷹之劍 (ver JAF)	黃金鷹之劍 (ver JAF)	Konami
mmaulers	究極戰隊 (ver EAA)	究極戰隊 (ver EAA)	Konami
dadandrn	究極戰隊 (ver JAA)	究極戰隊 (ver JAA)	Konami
dbz	七龍珠 Z	七龍珠 Z	Banpresto
dbz2	七龍珠 Z 2 - 超武鬥大會	七龍珠 Z 2 - 超武鬥大會	Banpresto
gradius3	宇宙巡航艦 III (日本版)	宇宙巡航艦 III (日本版)	Konami
grdius3a	宇宙巡航艦 III (亞洲版)	宇宙巡航艦 III (亞洲版)	Konami
grdius3e	宇宙巡航艦 III (世界版 ?)	宇宙巡航艦 III (世界版 ?)	Konami
gokuparo	極上瘋狂大射擊 (ver JAD)	極上瘋狂大射擊 (ver JAD)	Konami
fantjour	極上瘋狂大射擊 / Fantastic Journey	極上瘋狂大射擊 / Fantastic Journey	Konami
salmndr2	沙羅曼蛇 2 (ver JAA)	沙羅曼蛇 2 (ver JAA)	Konami
sexyparo	性感瘋狂大射擊 (ver JAA)	性感瘋狂大射擊 (ver JAA)	Konami
bm1stmix	節奏 DJ: 狂熱節拍 (ver JA-B)	節奏 DJ: 狂熱節拍 (ver JA-B)	Konami
bm2ndmix	節奏 DJ: 狂熱節拍 2nd MIX (ver JA-B)	節奏 DJ: 狂熱節拍 2nd MIX (ver JA-B)	Konami
bm2ndmxa	節奏 DJ: 狂熱節拍 2nd MIX (ver JA-A)	節奏 DJ: 狂熱節拍 2nd MIX (ver JA-A)	Konami
bmcompmx	節奏 DJ: 狂熱節拍 complete MIX (ver JA-B)	節奏 DJ: 狂熱節拍 complete MIX (ver JA-B)	Konami
hmcompmx	節奏 DJ: 狂熱節拍 complete MIX / hiphopmania complete MIX (ver UA-B)	節奏 DJ: 狂熱節拍 complete MIX / hiphopmania complete MIX (ver UA-B)	Konami
bm4thmix	節奏 DJ: 狂熱節拍 4th MIX - The beat goes on (ver JA-A)	節奏 DJ: 狂熱節拍 4th MIX - The beat goes on (ver JA-A)	Konami
bm5thmix	節奏 DJ: 狂熱節拍 5th MIX - Time to get down (ver JA-A)	節奏 DJ: 狂熱節拍 5th MIX - Time to get down (ver JA-A)	Konami
bmcorerm	節奏 DJ: 狂熱節拍 CORE REMIX (ver JA-A)	節奏 DJ: 狂熱節拍 CORE REMIX (ver JA-A)	Konami
bmdct	節奏 DJ: 狂熱節拍 featuring - Dreams Come True (ver JA-A)	節奏 DJ: 狂熱節拍 featuring - Dreams Come True (ver JA-A)	Konami
bmcompm2	節奏 DJ: 狂熱節拍 complete MIX 2 (ver JA-A)	節奏 DJ: 狂熱節拍 complete MIX 2 (ver JA-A)	Konami
hmcompm2	節奏 DJ: 狂熱節拍 complete MIX 2 / hiphopmania complete MIX 2 (ver UA-A)	節奏 DJ: 狂熱節拍 complete MIX 2 / hiphopmania complete MIX 2 (ver UA-A)	Konami
bm6thmix	節奏 DJ: 狂熱節拍 6th MIX - The UK underground music (ver JA-A)	節奏 DJ: 狂熱節拍 6th MIX - The UK underground music (ver JA-A)	Konami
hangplt	滑翔翼	滑翔翼	Konami
nbapbp	NBA 實況籃球	NBA 實況籃球	Konami
gradius4	宇宙巡航艦 4: 復活	宇宙巡航艦 4: 復活	Konami
midnrun	午夜快車	午夜快車	Konami
windheat	勁風賽車	勁風賽車	Konami
totlvice	狙擊雙槍 (ver JAA)	狙擊雙槍 (ver JAA)	Konami
evilngt	惡魔之夜 (ver EAA)	惡魔之夜 (ver EAA)	Konami
topsecex	最高機密 (Exidy) (version 1.0)	最高機密 (Exidy) (version 1.0)	Exidy
dominos	多米諾骨牌	多米諾骨牌	Atari
ultratnk	終極坦克	終極坦克	Atari
atarifb	Atari 足球 (revision 2)	Atari 足球 (revision 2)	Atari
atarifb1	Atari 足球 (revision 1)	Atari 足球 (revision 1)	Atari
atarifb4	Atari 足球 (4 players)	Atari 足球 (4 players)	Atari
bsktball	籃球	籃球	Atari
abaseb	Atari 棒球 (set 1)	Atari 棒球 (set 1)	Atari
abaseb2	Atari 棒球 (set 2)	Atari 棒球 (set 2)	Atari
soccer	Atari 足球	Atari 足球	Atari
missile	導彈指令 (set 1)	導彈指令 (set 1)	Atari
missile2	導彈指令 (set 2)	導彈指令 (set 2)	Atari
suprmatk	導彈指令 / Super Missile Attack (for set 2)	導彈指令 / Super Missile Attack (for set 2)	Atari + Gencomp
sprmatkd	導彈指令 / Super Missile Attack (未加密)	導彈指令 / Super Missile Attack (未加密)	Atari + Gencomp
asteroid	隕石大戰 (rev 2)	隕石大戰 (rev 2)	Atari
asteroi1	隕石大戰 (rev 1)	隕石大戰 (rev 1)	Atari
asteroib	隕石大戰 (盜版 Lunar Lander hardware)	隕石大戰 (盜版 Lunar Lander hardware)	bootleg
asterock	隕石大戰 / Asterock	隕石大戰 / Asterock	Sidam
meteorts	隕石大戰 / Meteorites	隕石大戰 / Meteorites	VGG
astdelux	隕石大戰 Deluxe (rev 2)	隕石大戰 Deluxe (rev 2)	Atari
astdelu1	隕石大戰 Deluxe (rev 1)	隕石大戰 Deluxe (rev 1)	Atari
tempest	暴風雨 (rev 3)	暴風雨 (rev 3)	Atari
tempest1	暴風雨 (rev 1)	暴風雨 (rev 1)	Atari
tempest2	暴風雨 (rev 2)	暴風雨 (rev 2)	Atari
tempest3	暴風雨 (rev ?)	暴風雨 (rev ?)	Atari
temptube	暴風雨 / Tempest Tubes	暴風雨 / Tempest Tubes	hack
starwars	星際大戰 (rev 2)	星際大戰 (rev 2)	Atari
starwar1	星際大戰 (rev 1)	星際大戰 (rev 1)	Atari
esb	星際大戰 - 帝國大反擊	星際大戰 - 帝國大反擊	Atari Games
foodf	食物大戰 (rev 3)	食物大戰 (rev 3)	Atari
foodf2	食物大戰 (rev 2)	食物大戰 (rev 2)	Atari
foodfc	食物大戰 (檯面型)	食物大戰 (檯面型)	Atari
ccastles	水晶城堡 (version 4)	水晶城堡 (version 4)	Atari
ccastle3	水晶城堡 (version 3)	水晶城堡 (version 3)	Atari
ccastle2	水晶城堡 (version 2)	水晶城堡 (version 2)	Atari
jedi	星際大戰 - 絕地大反擊	星際大戰 - 絕地大反擊	Atari
marble	瘋狂彈珠 (set 1)	瘋狂彈珠 (set 1)	Atari Games
marble2	瘋狂彈珠 (set 2)	瘋狂彈珠 (set 2)	Atari Games
marble3	瘋狂彈珠 (set 3)	瘋狂彈珠 (set 3)	Atari Games
marble4	瘋狂彈珠 (set 4)	瘋狂彈珠 (set 4)	Atari Games
indytemp	印第安那瓊斯和毀滅之殿 (set 1)	印第安那瓊斯和毀滅之殿 (set 1)	Atari Games
indytem2	印第安那瓊斯和毀滅之殿 (set 2)	印第安那瓊斯和毀滅之殿 (set 2)	Atari Games
indytem3	印第安那瓊斯和毀滅之殿 (set 3)	印第安那瓊斯和毀滅之殿 (set 3)	Atari Games
indytem4	印第安那瓊斯和毀滅之殿 (set 4)	印第安那瓊斯和毀滅之殿 (set 4)	Atari Games
indytemd	印第安那瓊斯和毀滅之殿 (德文)	印第安那瓊斯和毀滅之殿 (德文)	Atari Games
apb	APB - 全國大搜查 (rev 7)	APB - 全國大搜查 (rev 7)	Atari Games
apb6	APB - 全國大搜查 (rev 6)	APB - 全國大搜查 (rev 6)	Atari Games
apb5	APB - 全國大搜查 (rev 5)	APB - 全國大搜查 (rev 5)	Atari Games
apb4	APB - 全國大搜查 (rev 4)	APB - 全國大搜查 (rev 4)	Atari Games
apb3	APB - 全國大搜查 (rev 3)	APB - 全國大搜查 (rev 3)	Atari Games
apb2	APB - 全國大搜查 (rev 2)	APB - 全國大搜查 (rev 2)	Atari Games
apb1	APB - 全國大搜查 (rev 1)	APB - 全國大搜查 (rev 1)	Atari Games
apbg	APB - 全國大搜查 (德文)	APB - 全國大搜查 (德文)	Atari Games
apbf	APB - 全國大搜查 (法文)	APB - 全國大搜查 (法文)	Atari Games
gauntlet	聖鎧傳說 (rev 14)	聖鎧傳說 (rev 14)	Atari Games
gaunts	聖鎧傳說 (西班牙文, rev 15)	聖鎧傳說 (西班牙文, rev 15)	Atari Games
gauntj	聖鎧傳說 (日文, rev 13)	聖鎧傳說 (日文, rev 13)	Atari Games
gauntg	聖鎧傳說 (德文, rev 10)	聖鎧傳說 (德文, rev 10)	Atari Games
gauntj12	聖鎧傳說 (日文, rev 12)	聖鎧傳說 (日文, rev 12)	Atari Games
gauntr9	聖鎧傳說 (rev 9)	聖鎧傳說 (rev 9)	Atari Games
gauntgr8	聖鎧傳說 (德文, rev 8)	聖鎧傳說 (德文, rev 8)	Atari Games
gauntr7	聖鎧傳說 (rev 7)	聖鎧傳說 (rev 7)	Atari Games
gauntgr6	聖鎧傳說 (德文, rev 6)	聖鎧傳說 (德文, rev 6)	Atari Games
gauntr5	聖鎧傳說 (rev 5)	聖鎧傳說 (rev 5)	Atari Games
gauntr4	聖鎧傳說 (rev 4)	聖鎧傳說 (rev 4)	Atari Games
gauntgr3	聖鎧傳說 (德文, rev 3)	聖鎧傳說 (德文, rev 3)	Atari Games
gauntr2	聖鎧傳說 (rev 2)	聖鎧傳說 (rev 2)	Atari Games
gauntr1	聖鎧傳說 (rev 1)	聖鎧傳說 (rev 1)	Atari Games
gaunt2p	聖鎧傳說 (2 Players, rev 6)	聖鎧傳說 (2 Players, rev 6)	Atari Games
gaunt2pj	聖鎧傳說 (2 Players, 日文, rev 5)	聖鎧傳說 (2 Players, 日文, rev 5)	Atari Games
gaunt2pg	聖鎧傳說 (2 Players, 德文, rev 4)	聖鎧傳說 (2 Players, 德文, rev 4)	Atari Games
gaun2pr3	聖鎧傳說 (2 Players, rev 3)	聖鎧傳說 (2 Players, rev 3)	Atari Games
gaun2pj2	聖鎧傳說 (2 Players, 日文, rev 2)	聖鎧傳說 (2 Players, 日文, rev 2)	Atari Games
gaun2pg1	聖鎧傳說 (2 Players, 德文, rev 1)	聖鎧傳說 (2 Players, 德文, rev 1)	Atari Games
gaunt2	聖鎧傳說 II	聖鎧傳說 II	Atari Games
gaunt2g	聖鎧傳說 II (德文)	聖鎧傳說 II (德文)	Atari Games
gaunt22p	聖鎧傳說 II (2 Players, rev 2)	聖鎧傳說 II (2 Players, rev 2)	Atari Games
gaun22p1	聖鎧傳說 II (2 Players, rev 1)	聖鎧傳說 II (2 Players, rev 1)	Atari Games
gaun22pg	聖鎧傳說 II (2 Players, 德文)	聖鎧傳說 II (2 Players, 德文)	Atari Games
atetcktl	俄羅斯方塊 (檯面型 set 1)	俄羅斯方塊 (檯面型 set 1)	Atari Games
atetckt2	俄羅斯方塊 (檯面型 set 2)	俄羅斯方塊 (檯面型 set 2)	Atari Games
atetris	俄羅斯方塊 (set 1)	俄羅斯方塊 (set 1)	Atari Games
atetrisa	俄羅斯方塊 (set 2)	俄羅斯方塊 (set 2)	Atari Games
atetrisb	俄羅斯方塊 (盜版 set 1)	俄羅斯方塊 (盜版 set 1)	bootleg
atetrsb2	俄羅斯方塊 (盜版 set 2)	俄羅斯方塊 (盜版 set 2)	bootleg
eprom	機械怪獸大逃亡 (set 1)	機械怪獸大逃亡 (set 1)	Atari Games
eprom2	機械怪獸大逃亡 (set 2)	機械怪獸大逃亡 (set 2)	Atari Games
pitfight	死鬥戰士 (rev 5)	死鬥戰士 (rev 5)	Atari Games
pitfigh4	死鬥戰士 (rev 4)	死鬥戰士 (rev 4)	Atari Games
pitfigh3	死鬥戰士 (rev 3)	死鬥戰士 (rev 3)	Atari Games
pitfighj	死鬥戰士 (日本版, 2 players)	死鬥戰士 (日本版, 2 players)	Atari Games
pitfighb	死鬥戰士 (盜版)	死鬥戰士 (盜版)	Atari Games
batman	蝙蝠俠	蝙蝠俠	Atari Games
relief	後援投手 (set 1)	後援投手 (set 1)	Atari Games
relief2	後援投手 (set 2)	後援投手 (set 2)	Atari Games
arcadecl	業務機台經典名作 (開發版)	業務機台經典名作 (開發版)	Atari Games
primrage	恐龍格鬥 (version 2.3)	恐龍格鬥 (version 2.3)	Atari Games
primraga	恐龍格鬥 (version 2.0)	恐龍格鬥 (version 2.0)	Atari Games
area51	51 區特警 (R3000)	51 區特警 (R3000)	Atari Games
area51t	51 區特警 (Time Warner License)	51 區特警 (Time Warner License)	Time Warner
area51a	51 區特警 (Atari Games License)	51 區特警 (Atari Games License)	Atari Games
area51mx	51 區特警 / Maximum Force Duo v2.0	51 區特警 / Maximum Force Duo v2.0	Atari Games
a51mxr3k	51 區特警 / Maximum Force Duo (R3000)	51 區特警 / Maximum Force Duo (R3000)	Atari Games
maxforce	51 區特警 / Maximum Force v1.05	51 區特警 / Maximum Force v1.05	Atari Games
maxf_102	51 區特警 / Maximum Force v1.02	51 區特警 / Maximum Force v1.02	Atari Games
a51site4	51 區特警: Site 4	51 區特警: Site 4	Atari Games
sgladiat	劍鬥士 1984	劍鬥士 1984	SNK
aso	ASO - 組合戰機	ASO - 組合戰機	SNK
alphamis	ASO - 組合戰機 / ALPHA 任務	ASO - 組合戰機 / ALPHA 任務	SNK
tnk3	大坦克 / T.N.K. III (美國版)	大坦克 / T.N.K. III (美國版)	SNK
tnk3j	大坦克 (日本版)	大坦克 (日本版)	SNK
ikari	怒 / Ikari Warriors (美國版)	怒 / Ikari Warriors (美國版)	SNK
ikarijp	怒 (日本版)	怒 (日本版)	SNK
ikarijpb	怒 (日本版 盜版)	怒 (日本版 盜版)	bootleg
victroad	怒號層圈 / 勝利之路	怒號層圈 / 勝利之路	SNK
dogosoke	怒號層圈	怒號層圈	SNK
dogosokj	怒號層圈 (搖桿 盜版)	怒號層圈 (搖桿 盜版)	bootleg
gwar	革命英雄 / Guerrilla War (美國版)	革命英雄 / Guerrilla War (美國版)	SNK
gwarj	革命英雄 (日本版)	革命英雄 (日本版)	SNK
gwara	革命英雄 (Version 1)	革命英雄 (Version 1)	SNK
gwarb	革命英雄 (盜版)	革命英雄 (盜版)	bootleg
bermudat	百慕達魔鬼三角 (日本版)	百慕達魔鬼三角 (日本版)	SNK
bermudao	百慕達魔鬼三角 (日本版 舊版)	百慕達魔鬼三角 (日本版 舊版)	SNK
bermudaa	百慕達魔鬼三角 (美國版 舊版)	百慕達魔鬼三角 (美國版 舊版)	SNK
worldwar	百慕達魔鬼三角 / 世界大戰 (世界版)	百慕達魔鬼三角 / 世界大戰 (世界版)	SNK
psychos	超能力戰士 (美國版)	超能力戰士 (美國版)	SNK
psychosj	超能力戰士 (日本版)	超能力戰士 (日本版)	SNK
chopper	航空騎兵物語 (美國版 set 1)	航空騎兵物語 (美國版 set 1)	SNK
choppera	航空騎兵物語 (美國版 set 2)	航空騎兵物語 (美國版 set 2)	SNK
chopperb	航空騎兵物語 (美國版 set 3)	航空騎兵物語 (美國版 set 3)	SNK
legofair	航空騎兵物語 / Koukuu Kihei Monogatari - The Legend of Air Cavalry (日本版)	航空騎兵物語 / Koukuu Kihei Monogatari - The Legend of Air Cavalry (日本版)	SNK
ikari3	怒 III (Rotary Joystick)	怒 III (Rotary Joystick)	SNK
ikari3nr	怒 III (8-Way Joystick)	怒 III (8-Way Joystick)	SNK
pow	脫獄 - Prisoners of War / P.O.W. - Prisoners of War (美國版)	脫獄 - Prisoners of War / P.O.W. - Prisoners of War (美國版)	SNK
powj	脫獄 - Prisoners of War (日本版)	脫獄 - Prisoners of War (日本版)	SNK
searchar	異形大作戰 / SAR - 搜救 (世界版)	異形大作戰 / SAR - 搜救 (世界版)	SNK
sercharu	異形大作戰 / SAR - 搜救 (美國版)	異形大作戰 / SAR - 搜救 (美國版)	SNK
sercharj	異形大作戰 / SAR - 搜救 (日本版)	異形大作戰 / SAR - 搜救 (日本版)	SNK
prehisle	原始島 1930 (世界版)	原始島 1930 (世界版)	SNK
prehislu	原始島 1930 (美國版)	原始島 1930 (美國版)	SNK of America
gensitou	原始島 1930	原始島 1930	SNK
bbusters	野獸剋星 (世界版 ?)	野獸剋星 (世界版 ?)	SNK
nam1975	越戰-1975	越戰-1975	SNK
bstars	棒球之星 Professional	棒球之星 Professional	SNK
tpgolf	頂尖高爾夫	頂尖高爾夫	SNK
mahretsu	麻雀狂列傳 - 西日本篇	麻雀狂列傳 - 西日本篇	SNK
maglord	幻魔大戰 (set 1)	幻魔大戰 (set 1)	Alpha Denshi Co.
maglordh	幻魔大戰 (set 2)	幻魔大戰 (set 2)	Alpha Denshi Co.
ridhero	風速英雄 (set 1)	風速英雄 (set 1)	SNK
ridheroh	風速英雄 (set 2)	風速英雄 (set 2)	SNK
alpham2	ASO II - 最後的守護神 / ALPHA 任務 II	ASO II - 最後的守護神 / ALPHA 任務 II	SNK
ncombat	忍者大戰 (set 1)	忍者大戰 (set 1)	Alpha Denshi Co.
ncombata	忍者大戰 (set 2)	忍者大戰 (set 2)	Alpha Denshi Co.
cyberlip	戰鬥邊緣	戰鬥邊緣	SNK
superspy	諜報飛龍	諜報飛龍	SNK
mutnat	外星遊龍	外星遊龍	SNK
kotm	怪獸之王 (set 1)	怪獸之王 (set 1)	SNK
kotmh	怪獸之王 (set 2)	怪獸之王 (set 2)	SNK
sengoku	戰國傳承 (set 1)	戰國傳承 (set 1)	SNK
sengokh	戰國傳承 (set 2)	戰國傳承 (set 2)	SNK
burningf	熱血快打 (set 1)	熱血快打 (set 1)	SNK
burningh	熱血快打 (set 2)	熱血快打 (set 2)	SNK
lbowling	超級保齡球	超級保齡球	SNK
gpilots	幽靈戰區	幽靈戰區	SNK
joyjoy	陽光方塊	陽光方塊	SNK
bjourney	拉吉少年	拉吉少年	Alpha Denshi Co.
quizdais	解謎大搜查線	解謎大搜查線	SNK
lresort	終極任務	終極任務	SNK
eightman	8 號超人	8 號超人	SNK / Pallas
minasan	麻雀大賽	麻雀大賽	Monolith Corp.
legendos	小拳王	小拳王	SNK
2020bb	2020 年未來棒球 (set 1)	2020 年未來棒球 (set 1)	SNK / Pallas
2020bba	2020 年未來棒球 (set 2)	2020 年未來棒球 (set 2)	SNK / Pallas
2020bbh	2020 年未來棒球 (set 3)	2020 年未來棒球 (set 3)	SNK / Pallas
socbrawl	機器人足球	機器人足球	SNK
roboarmy	機甲神兵 (set 1)	機甲神兵 (set 1)	SNK
roboarma	機甲神兵 (set 2)	機甲神兵 (set 2)	SNK
fatfury1	餓狼傳說	餓狼傳說	SNK
fbfrenzy	瘋狂美式足球	瘋狂美式足球	SNK
bakatono	傻瓜殿下麻雀漫遊記	傻瓜殿下麻雀漫遊記	Monolith Corp.
crsword	聖十字劍	聖十字劍	Alpha Denshi Co.
trally	極速英豪	極速英豪	Alpha Denshi Co.
kotm2	怪獸之王 2	怪獸之王 2	SNK
sengoku2	戰國傳承 2	戰國傳承 2	SNK
bstars2	棒球之星 2	棒球之星 2	SNK
quizdai2	解謎大搜查線 Part 2	解謎大搜查線 Part 2	SNK
3countb	火燄摔角	火燄摔角	SNK
aof	龍虎拳	龍虎拳	SNK
samsho	侍魂	侍魂	SNK
tophuntr	頂尖獵人 (set 1)	頂尖獵人 (set 1)	SNK
tophunta	頂尖獵人 (set 2)	頂尖獵人 (set 2)	SNK
fatfury2	餓狼傳說 2	餓狼傳說 2	SNK
janshin	雀神傳說	雀神傳說	Aicom
androdun	雷霆任務	雷霆任務	Visco
ncommand	忍者戰士	忍者戰士	Alpha Denshi Co.
viewpoin	V 計劃 / 視點	V 計劃 / 視點	Sammy
ssideki	得點王 / Super Sidekicks	得點王 / Super Sidekicks	SNK
wh1	英雄榜 (set 1)	英雄榜 (set 1)	Alpha Denshi Co.
wh1h	英雄榜 (set 2)	英雄榜 (set 2)	Alpha Denshi Co.
kof94	拳皇 '94	拳皇 '94	SNK
aof2	龍虎拳 2 (set 1)	龍虎拳 2 (set 1)	SNK
aof2a	龍虎拳 2 (set 2)	龍虎拳 2 (set 2)	SNK
wh2	英雄榜 2	英雄榜 2	ADK
fatfursp	餓狼傳說 特別版 (set 1)	餓狼傳說 特別版 (set 1)	SNK
fatfursa	餓狼傳說 特別版 (set 2)	餓狼傳說 特別版 (set 2)	SNK
savagere	風雲默示錄 - 格鬥創世	風雲默示錄 - 格鬥創世	SNK
fightfev	狂熱戰鬥 (set 1)	狂熱戰鬥 (set 1)	Viccom
fightfva	狂熱戰鬥 (set 2)	狂熱戰鬥 (set 2)	Viccom
ssideki2	得點王 2 / Super Sidekicks 2	得點王 2 / Super Sidekicks 2	SNK
spinmast	強尼大冒險	強尼大冒險	Data East Corporation
samsho2	侍魂 II / 真侍魂 - 霸王丸地獄變	侍魂 II / 真侍魂 - 霸王丸地獄變	SNK
wh2j	英雄榜 2 JET	英雄榜 2 JET	ADK / SNK
wjammers	超級飛碟球	超級飛碟球	Data East Corporation
karnovr	格鬥列傳	格鬥列傳	Data East Corporation
gururin	旋轉方塊	旋轉方塊	Face
pspikes2	超級排球 II	超級排球 II	Video System Co.
fatfury3	餓狼傳說 3	餓狼傳說 3	SNK
zupapa	星星大作戰!	星星大作戰!	SNK
zupapad	星星大作戰! (定製解密 C)	星星大作戰! (定製解密 C)	SNK
panicbom	炸彈超人方塊	炸彈超人方塊	Eighting / Hudson
aodk	熱血進行曲 / 痛快 GANGAN 進行曲	熱血進行曲 / 痛快 GANGAN 進行曲	ADK / SNK
sonicwi2	音速戰機 2 / Aero Fighters 2	音速戰機 2 / Aero Fighters 2	Video System Co.
zedblade	末日之戰	末日之戰	NMK
galaxyfg	銀河快打	銀河快打	Sunsoft
strhoop	夢幻籃球賽	夢幻籃球賽	Data East Corporation
quizkof	拳皇問答	拳皇問答	Saurus
ssideki3	得點王 3 / Super Sidekicks 3	得點王 3 / Super Sidekicks 3	SNK
doubledr	雙截龍格鬥 (Neo-Geo)	雙截龍格鬥 (Neo-Geo)	Technos
pbobblen	泡泡龍解謎 (Neo-Geo) (set 1)	泡泡龍解謎 (Neo-Geo) (set 1)	Taito
pbobblna	泡泡龍解謎 (Neo-Geo) (set 2)	泡泡龍解謎 (Neo-Geo) (set 2)	Taito
kof95	拳皇 '95 (set 1)	拳皇 '95 (set 1)	SNK
kof95a	拳皇 '95 (set 2)	拳皇 '95 (set 2)	SNK
tws96	Tecmo 世界盃足球 '96	Tecmo 世界盃足球 '96	Tecmo
samsho3	侍魂 III / 侍魂 - 斬紅郎無雙劍 (set 1)	侍魂 III / 侍魂 - 斬紅郎無雙劍 (set 1)	SNK
samsho3a	侍魂 III / 侍魂 - 斬紅郎無雙劍 (set 2)	侍魂 III / 侍魂 - 斬紅郎無雙劍 (set 2)	SNK
fswords	侍魂 III / 侍魂 - 斬紅郎無雙劍 / Fighters Swords (韓文版)	侍魂 III / 侍魂 - 斬紅郎無雙劍 / Fighters Swords (韓文版)	SNK
stakwin	騎手之路	騎手之路	Saurus
pulstar	死亡之星	死亡之星	Aicom
whp	英雄榜 完美版	英雄榜 完美版	ADK / SNK
kabukikl	天外魔境真傳	天外魔境真傳	Hudson
neobombe	NEO 炸彈超人	NEO 炸彈超人	Hudson
gowcaizr	超人學園	超人學園	Technos
rbff1	Real Bout 餓狼傳說	Real Bout 餓狼傳說	SNK
aof3	龍虎拳 3 / 龍虎拳外傳	龍虎拳 3 / 龍虎拳外傳	SNK
aof3k	龍虎拳 3 / 龍虎拳外傳 (韓文版)	龍虎拳 3 / 龍虎拳外傳 (韓文版)	SNK
sonicwi3	音速戰機 3 / Aero Fighters 3	音速戰機 3 / Aero Fighters 3	Video System Co.
turfmast	NEO 高爾夫大師 / 高爾夫大賽	NEO 高爾夫大師 / 高爾夫大賽	Nazca
mslug	越南大戰: 合金彈頭	越南大戰: 合金彈頭	Nazca
puzzledp	解謎氣泡!	解謎氣泡!	Taito (Visco license)
mosyougi	將棋達人	將棋達人	ADK / SNK
marukodq	小丸子問答	小丸子問答	Takara
neomrdo	NEO 杜先生	NEO 杜先生	Visco
sdodgeb	超級躲避球	超級躲避球	Technos
goalx3	射門! 射門! 射門!	射門! 射門! 射門!	Visco
zintrckb	水滴方塊 (hack / 盜版)	水滴方塊 (hack / 盜版)	hack / bootleg
zintrkcd	水滴方塊 (CD to MVS Conversion)	水滴方塊 (CD to MVS Conversion)	Razoola
overtop	極速賽車	極速賽車	ADK
neodrift	NEO 越野賽車	NEO 越野賽車	Visco
kof96	拳皇 '96 (set 1)	拳皇 '96 (set 1)	SNK
kof96h	拳皇 '96 (set 2)	拳皇 '96 (set 2)	SNK
kof96ep	拳皇 '96 (盜版)	拳皇 '96 (盜版)	bootleg
ssideki4	得點王四 / The Ultimate 11 - SNK Football Championship	得點王四 / The Ultimate 11 - SNK Football Championship	SNK
kizuna	風雲默示錄 2 - 超級組隊戰	風雲默示錄 2 - 超級組隊戰	SNK
ninjamas	霸王忍法帖	霸王忍法帖	ADK / SNK
ragnagrd	神凰拳	神凰拳	Saurus
pgoal	英式足球	英式足球	Saurus
magdrop2	魔法氣泡 II	魔法氣泡 II	Data East Corporation
samsho4	侍魂 IV / 侍魂 - 天草降臨	侍魂 IV / 侍魂 - 天草降臨	SNK
rbffspec	Real Bout 餓狼傳說 特別版	Real Bout 餓狼傳說 特別版	SNK
twinspri	夢幻小妖精	夢幻小妖精	ADK
wakuwak7	7 戰士	7 戰士	Sunsoft
stakwin2	騎手之路 2	騎手之路 2	Saurus
ghostlop	魔鬼飛行員 (開發版)	魔鬼飛行員 (開發版)	Data East Corporation
breakers	爆烈人	爆烈人	Visco
miexchng	金錢方塊	金錢方塊	Face
kof97	拳皇 '97 (set 1)	拳皇 '97 (set 1)	SNK
kof97a	拳皇 '97 (set 2)	拳皇 '97 (set 2)	SNK
kof97pls	拳皇 '97 風雲再起 PLUS (盜版)	拳皇 '97 風雲再起 PLUS (盜版)	bootleg
kog	拳皇 '97 / King of Gladiator (盜版)	拳皇 '97 / King of Gladiator (盜版)	bootleg
magdrop3	魔法氣泡 III	魔法氣泡 III	Data East Corporation
lastblad	幕末浪漫 月華劍士 (set 1)	幕末浪漫 月華劍士 (set 1)	SNK
lastblda	幕末浪漫 月華劍士 (set 2)	幕末浪漫 月華劍士 (set 2)	SNK
lastsold	幕末浪漫 月華劍士 / The Last Solider (韓文版)	幕末浪漫 月華劍士 / The Last Solider (韓文版)	SNK
puzzldpr	解謎氣泡! R!	解謎氣泡! R!	Taito (Visco license)
irrmaze	電流急急棒	電流急急棒	SNK / Saurus
popbounc	動物方塊	動物方塊	Video System Co.
shocktro	突擊騎兵 (set 1)	突擊騎兵 (set 1)	Saurus
shocktra	突擊騎兵 (set 2)	突擊騎兵 (set 2)	Saurus
blazstar	燃燒之星	燃燒之星	Yumekobo
rbff2	Real Bout 餓狼傳說 2 - 新挑戰者 (set 1)	Real Bout 餓狼傳說 2 - 新挑戰者 (set 1)	SNK
rbff2a	Real Bout 餓狼傳說 2 - 新挑戰者 (set 2)	Real Bout 餓狼傳說 2 - 新挑戰者 (set 2)	SNK
rbff2k	Real Bout 餓狼傳說 2 - 新挑戰者 (韓文版)	Real Bout 餓狼傳說 2 - 新挑戰者 (韓文版)	SNK
mslug2	越南大戰: 合金彈頭 2	越南大戰: 合金彈頭 2	SNK
kof98	拳皇 '98 - 夢幻戰役	拳皇 '98 - 夢幻戰役	SNK
kof98k	拳皇 '98 - 夢幻戰役 (韓文機板)	拳皇 '98 - 夢幻戰役 (韓文機板)	SNK
kof98n	拳皇 '98 - 夢幻戰役 (未加密)	拳皇 '98 - 夢幻戰役 (未加密)	SNK
lastbld2	幕末浪漫 月華劍士 2	幕末浪漫 月華劍士 2	SNK
neocup98	Neo-Geo 盃足球賽 '98 - 勝利之路	Neo-Geo 盃足球賽 '98 - 勝利之路	SNK
breakrev	爆烈人 復仇	爆烈人 復仇	Visco
shocktr2	突擊騎兵 2 - 第二縱隊	突擊騎兵 2 - 第二縱隊	Saurus
lans2004	突擊騎兵 2 - 第二縱隊 / Lansquenet 2004 (盜版)	突擊騎兵 2 - 第二縱隊 / Lansquenet 2004 (盜版)	bootleg
flipshot	盾牌大戰	盾牌大戰	Visco
pbobbl2n	泡泡龍解謎 2 (Neo-Geo)	泡泡龍解謎 2 (Neo-Geo)	Taito (SNK license)
ctomaday	蕃茄大作戰	蕃茄大作戰	Visco
mslugx	越南大戰: 合金彈頭 X	越南大戰: 合金彈頭 X	SNK
kof99	拳皇 '99 - 千禧年之戰 (set 1)	拳皇 '99 - 千禧年之戰 (set 1)	SNK
kof99a	拳皇 '99 - 千禧年之戰 (set 2)	拳皇 '99 - 千禧年之戰 (set 2)	SNK
kof99e	拳皇 '99 - 千禧年之戰 (早期版)	拳皇 '99 - 千禧年之戰 (早期版)	SNK
kof99n	拳皇 '99 - 千禧年之戰 (未加密)	拳皇 '99 - 千禧年之戰 (未加密)	SNK
kof99p	拳皇 '99 - 千禧年之戰 (開發版)	拳皇 '99 - 千禧年之戰 (開發版)	SNK
kof99d	拳皇 '99 - 千禧年之戰 (解密 C)	拳皇 '99 - 千禧年之戰 (解密 C)	SNK
ganryu	武藏嚴流記	武藏嚴流記	Visco
ganryud	武藏嚴流記 (解密 C)	武藏嚴流記 (解密 C)	Visco
garou	餓狼 - 群狼之證 (set 1)	餓狼 - 群狼之證 (set 1)	SNK
garouo	餓狼 - 群狼之證 (set 2)	餓狼 - 群狼之證 (set 2)	SNK
garoup	餓狼 - 群狼之證 (開發版)	餓狼 - 群狼之證 (開發版)	SNK
garoud	餓狼 - 群狼之證 (解密 C)	餓狼 - 群狼之證 (解密 C)	SNK
s1945p	打擊者 1945 PLUS	打擊者 1945 PLUS	Psikyo
s1945pd	打擊者 1945 PLUS (解密 C)	打擊者 1945 PLUS (解密 C)	Psikyo
preisle2	原始島 2	原始島 2	Yumekobo
preisl2d	原始島 2 (解密 C)	原始島 2 (解密 C)	Yumekobo
mslug3	越南大戰: 合金彈頭 3	越南大戰: 合金彈頭 3	SNK
mslug3n	越南大戰: 合金彈頭 3 (未加密)	越南大戰: 合金彈頭 3 (未加密)	SNK
mslug3d	越南大戰: 合金彈頭 3 (解密 C)	越南大戰: 合金彈頭 3 (解密 C)	SNK
mslug3b6	越南大戰: 合金彈頭 3 / Metal Slug 6 (盜版)	越南大戰: 合金彈頭 3 / Metal Slug 6 (盜版)	bootleg
kof2000	拳皇 2000	拳皇 2000	SNK
kof2000n	拳皇 2000 (未加密)	拳皇 2000 (未加密)	SNK
kof2000d	拳皇 2000 (解密 C)	拳皇 2000 (解密 C)	SNK
bangbead	衝擊彈珠	衝擊彈珠	Visco
nitd	黑暗守墓者	黑暗守墓者	Eleven / Gavaking
nitdd	黑暗守墓者 (解密 C)	黑暗守墓者 (解密 C)	Eleven / Gavaking
sengoku3	戰國傳承 3	戰國傳承 3	SNK
sengok3d	戰國傳承 3 (解密 C)	戰國傳承 3 (解密 C)	SNK
kof2001	拳皇 2001 (set 1)	拳皇 2001 (set 1)	Eolith / SNK
kof2001h	拳皇 2001 (set 2)	拳皇 2001 (set 2)	Eolith / SNK
kof2001d	拳皇 2001 (解密 C)	拳皇 2001 (解密 C)	Eolith / SNK
kf2k1pls	拳皇 2001 增強型 PLUS (set 1, 盜版)	拳皇 2001 增強型 PLUS (set 1, 盜版)	bootleg
kf2k1pa	拳皇 2001 風雲再起 PLUS (set 2, 盜版)	拳皇 2001 風雲再起 PLUS (set 2, 盜版)	bootleg
cthd2003	拳皇 2001 / 臥虎藏龍 2003 (盜版)	拳皇 2001 / 臥虎藏龍 2003 (盜版)	bootleg
cthd2k3a	拳皇 2001 / 臥虎藏龍 2003 (盜版, set 2)	拳皇 2001 / 臥虎藏龍 2003 (盜版, set 2)	bootleg
ct2k3sp	拳皇 2001 / 臥虎藏龍 2003 風雲 SUPER PLUS (盜版)	拳皇 2001 / 臥虎藏龍 2003 風雲 SUPER PLUS (盜版)	bootleg
mslug4	越南大戰: 合金彈頭 4	越南大戰: 合金彈頭 4	Mega
mslug4d	越南大戰: 合金彈頭 4 (解密 C)	越南大戰: 合金彈頭 4 (解密 C)	Mega
ms4plus	越南大戰: 合金彈頭 4 增強型 PLUS (盜版)	越南大戰: 合金彈頭 4 增強型 PLUS (盜版)	bootleg
rotd	龍拳	龍拳	Evoga / Playmore
rotdd	龍拳 (解密 C)	龍拳 (解密 C)	Evoga / Playmore
kof2002	拳皇 2002	拳皇 2002	Eolith / Playmore
kof2002d	拳皇 2002 (解密 C)	拳皇 2002 (解密 C)	Eolith / Playmore
kof2002b	拳皇 2002 (盜版)	拳皇 2002 (盜版)	bootleg
kf2k2pls	拳皇 2002 風雲再起 (set 1, 盜版)	拳皇 2002 風雲再起 (set 1, 盜版)	bootleg
kf2k2pla	拳皇 2002 風雲再起 PLUS (set 2, 盜版)	拳皇 2002 風雲再起 PLUS (set 2, 盜版)	bootleg
kf2k2plb	拳皇 2002 PLUS (set 3, 盜版)	拳皇 2002 PLUS (set 3, 盜版)	bootleg
kf2k2plc	拳皇 2002 SUPER (set 4, 盜版)	拳皇 2002 SUPER (set 4, 盜版)	bootleg
kf2k2mp	拳皇 2002 MAGIC PLUS (盜版)	拳皇 2002 MAGIC PLUS (盜版)	bootleg
kf2k2mp2	拳皇 2002 MAGIC PLUS II (盜版)	拳皇 2002 MAGIC PLUS II (盜版)	bootleg
kof10th	拳皇 2002 / 拳皇 10 週年紀念 (盜版)	拳皇 2002 / 拳皇 10 週年紀念 (盜版)	bootleg
kf2k5uni	拳皇 2002 / 拳皇 10 週年紀念 2005 UNIQUE (盜版)	拳皇 2002 / 拳皇 10 週年紀念 2005 UNIQUE (盜版)	bootleg
kf10thep	拳皇 2002 / 拳皇 10 週年紀念 EXTRA PLUS (盜版)	拳皇 2002 / 拳皇 10 週年紀念 EXTRA PLUS (盜版)	bootleg
kof2k4se	拳皇 2002 / 拳皇 SPECIAL EDITION 2004 (盜版)	拳皇 2002 / 拳皇 SPECIAL EDITION 2004 (盜版)	bootleg
kf2k4pls	拳皇 2002 / 拳皇 SPECIAL EDITION 2004 PLUS (盜版)	拳皇 2002 / 拳皇 SPECIAL EDITION 2004 PLUS (盜版)	bootleg
matrim	新豪血寺一族 - 鬥婚	新豪血寺一族 - 鬥婚	Noise Factory / Atlus
matrimd	新豪血寺一族 - 鬥婚 (解密 C)	新豪血寺一族 - 鬥婚 (解密 C)	Noise Factory / Atlus
matrimbl	新豪血寺一族 - 鬥婚 (盜版)	新豪血寺一族 - 鬥婚 (盜版)	bootleg
pnyaa	寵物方塊	寵物方塊	Aiky / Taito
ms5pcb	越南大戰: 合金彈頭 5 (JAMMA PCB)	越南大戰: 合金彈頭 5 (JAMMA PCB)	SNK Playmore
mslug5	越南大戰: 合金彈頭 5	越南大戰: 合金彈頭 5	SNK Playmore
ms5plus	越南大戰: 合金彈頭 5 PLUS (盜版)	越南大戰: 合金彈頭 5 PLUS (盜版)	bootleg
svcpcb	SNK VS. 卡普空 - SVC 渾沌 (JAMMA PCB)	SNK VS. 卡普空 - SVC 渾沌 (JAMMA PCB)	Playmore
svcpcba	SNK VS. 卡普空 - SVC 渾沌 (JAMMA PCB, set 2)	SNK VS. 卡普空 - SVC 渾沌 (JAMMA PCB, set 2)	Playmore
svc	SNK VS. 卡普空 - SVC 渾沌 (MVS)	SNK VS. 卡普空 - SVC 渾沌 (MVS)	Playmore
svcboot	SNK VS. 卡普空 - SVC 渾沌 (MVS) (盜版)	SNK VS. 卡普空 - SVC 渾沌 (MVS) (盜版)	bootleg
svcplus	SNK VS. 卡普空 - SVC 渾沌 PLUS (set 1, 盜版)	SNK VS. 卡普空 - SVC 渾沌 PLUS (set 1, 盜版)	bootleg
svcplusa	SNK VS. 卡普空 - SVC 渾沌 PLUS (set 2, 盜版)	SNK VS. 卡普空 - SVC 渾沌 PLUS (set 2, 盜版)	bootleg
svcsplus	SNK VS. 卡普空 - SVC 渾沌 SUPER PLUS (盜版)	SNK VS. 卡普空 - SVC 渾沌 SUPER PLUS (盜版)	bootleg
samsho5	侍魂 V / 侍魂零 (set 1)	侍魂 V / 侍魂零 (set 1)	Yuki Enterprise / SNK Playmore
samsho5h	侍魂 V / 侍魂零 (set 2)	侍魂 V / 侍魂零 (set 2)	Yuki Enterprise / SNK Playmore
samsho5b	侍魂 V / 侍魂零 (盜版)	侍魂 V / 侍魂零 (盜版)	bootleg
kf2k3pcb	拳皇 2003 (日本版, JAMMA PCB)	拳皇 2003 (日本版, JAMMA PCB)	SNK Playmore
kof2003	拳皇 2003 (世界版 / 美國版, MVS)	拳皇 2003 (世界版 / 美國版, MVS)	SNK Playmore
kf2k3bl	拳皇 2003 (盜版, set 1)	拳皇 2003 (盜版, set 1)	bootleg
kf2k3bla	拳皇 2003 (盜版, set 2)	拳皇 2003 (盜版, set 2)	bootleg
kf2k3pl	拳皇 2003 / 拳皇 2004 HERO (盜版)	拳皇 2003 / 拳皇 2004 HERO (盜版)	bootleg
kf2k3upl	拳皇 2003 / 拳皇 2004 風雲 PLUS (盜版)	拳皇 2003 / 拳皇 2004 風雲 PLUS (盜版)	bootleg
samsh5sp	侍魂 V 特別版 / 侍魂零 特別版 (set 1, uncensored)	侍魂 V 特別版 / 侍魂零 特別版 (set 1, uncensored)	Yuki Enterprise / SNK Playmore
samsh5sh	侍魂 V 特別版 / 侍魂零 特別版 (set 2, censored)	侍魂 V 特別版 / 侍魂零 特別版 (set 2, censored)	Yuki Enterprise / SNK Playmore
samsh5sn	侍魂 V 特別版 / 侍魂零 特別版 (set 3, less censored)	侍魂 V 特別版 / 侍魂零 特別版 (set 3, less censored)	Yuki Enterprise / SNK Playmore
jockeygp	賭馬	賭馬	Sun Amusement / BrezzaSoft
vliner	水果單機 (set 1)	水果單機 (set 1)	Dyna / BreezaSoft
vlinero	水果單機 (set 2)	水果單機 (set 2)	Dyna / BreezaSoft
beast	野獸之瞳 (Neo Demo)	野獸之瞳 (Neo Demo)	Psygnosis
columnsn	寶石方塊 (Neo-Geo)	寶石方塊 (Neo-Geo)	Sega
poknight	撲克之夜	撲克之夜	JMK
diggerma	挖地先生	挖地先生	Unknown
neonopon	NEO 智力方塊 (beta)	NEO 智力方塊 (beta)	Blastar
neopong	NEO 彈球 (v1.1)	NEO 彈球 (v1.1)	Neodev
npong10	NEO 彈球 (v1.0)	NEO 彈球 (v1.0)	Neodev
syscheck	NEO 系統檢查 (ver 1.0b)	NEO 系統檢查 (ver 1.0b)	Blastar
frogfest	青蛙盛宴	青蛙盛宴	Rastersoft
roadedge	休旅賽車 (rev.B)	休旅賽車 (rev.B)	SNK
sams64_2	侍魂之霸王傳說 / 侍魂 2: 阿修羅斬魔傳	侍魂之霸王傳說 / 侍魂 2: 阿修羅斬魔傳	SNK
fatfurwa	餓狼傳說: Wild Ambition (rev.A)	餓狼傳說: Wild Ambition (rev.A)	SNK
buriki	武力 ONE (rev.B)	武力 ONE (rev.B)	SNK
shougi	將棋	將棋	Alpha Denshi
shougi2	將棋 2	將棋 2	Alpha Denshi
champbas	冠軍棒球	冠軍棒球	Sega
champbbj	冠軍棒球 (日本版 set 1)	冠軍棒球 (日本版 set 1)	Alpha Denshi Co.
champbja	冠軍棒球 (日本版 set 2)	冠軍棒球 (日本版 set 2)	Alpha Denshi Co.
champbb2	冠軍棒球 II (set 1)	冠軍棒球 II (set 1)	Sega
champb2a	冠軍棒球 II (set 2)	冠軍棒球 II (set 2)	Alpha Denshi Co.
exctsccr	奮鬥足球	奮鬥足球	Alpha Denshi Co.
exctscca	奮鬥足球 (alternate music)	奮鬥足球 (alternate music)	Alpha Denshi Co.
exctsccb	奮鬥足球 (盜版)	奮鬥足球 (盜版)	bootleg
exctscc2	奮鬥足球 II	奮鬥足球 II	Alpha Denshi Co.
gekisou	激走 (日本版)	激走 (日本版)	Eastern
kouyakyu	高校野球	高校野球	Alpha Denshi Co.
skysoldr	空中騎士 (美國版)	空中騎士 (美國版)	[Alpha Denshi Co.] (SNK of America/Romstar license)
skyadvnt	天空大冒險 (世界版)	天空大冒險 (世界版)	Alpha Denshi Co.
skyadvnu	天空大冒險 (美國版)	天空大冒險 (美國版)	Alpha Denshi Co. (SNK of America license)
skyadvnj	天空大冒險 (日本版)	天空大冒險 (日本版)	Alpha Denshi Co.
gangwars	群毆 (美國版)	群毆 (美國版)	Alpha Denshi Co.
gangwarb	群毆 (盜版)	群毆 (盜版)	bootleg
meijinsn	名人戰	名人戰	SNK Electronics corp.
ssozumo	出世大相撲 (日本版)	出世大相撲 (日本版)	Technos
mystston	秘石 / Mysterious Stones - Dr. John's Adventure	秘石 / Mysterious Stones - Dr. John's Adventure	Technos
myststno	秘石	秘石	Technos
matmania	瘋狂摔角 / Mat Mania	瘋狂摔角 / Mat Mania	Technos (Taito America license)
excthour	瘋狂摔角	瘋狂摔角	Technos (Taito license)
renegade	熱血硬派 / Renegade (美國版)	熱血硬派 / Renegade (美國版)	Technos (Taito America license)
kuniokun	熱血硬派 (日本版)	熱血硬派 (日本版)	Technos
kuniokub	熱血硬派 (日本版 盜版)	熱血硬派 (日本版 盜版)	bootleg
ddragon	雙截龍 (日本版)	雙截龍 (日本版)	Technos
ddragonu	雙截龍 (美國版)	雙截龍 (美國版)	[Technos] (Taito America license)
ddragonw	雙截龍 (世界版 Set 1)	雙截龍 (世界版 Set 1)	[Technos] (Taito license)
ddragnw1	雙截龍 (世界版 Set 2)	雙截龍 (世界版 Set 2)	[Technos] (Taito license)
ddragonb	雙截龍 (盜版)	雙截龍 (盜版)	bootleg
spdodgeb	熱血高校躲避球 / Super Dodge Ball (美國版)	熱血高校躲避球 / Super Dodge Ball (美國版)	Technos
nkdodgeb	熱血高校躲避球 (日本版 盜版)	熱血高校躲避球 (日本版 盜版)	Technos
chinagat	西遊降魔錄 - 流棒妖技之章 / China Gate (美國版)	西遊降魔錄 - 流棒妖技之章 / China Gate (美國版)	[Technos] (Taito Romstar license)
saiyugou	西遊降魔錄 - 流棒妖技之章 (日本版)	西遊降魔錄 - 流棒妖技之章 (日本版)	Technos
saiyugb1	西遊降魔錄 - 流棒妖技之章 (日本版 盜版 1)	西遊降魔錄 - 流棒妖技之章 (日本版 盜版 1)	bootleg
saiyugb2	西遊降魔錄 - 流棒妖技之章 (日本版 盜版 2)	西遊降魔錄 - 流棒妖技之章 (日本版 盜版 2)	bootleg
wwfsstar	WWF 超級明星 (歐洲版)	WWF 超級明星 (歐洲版)	Technos Japan
wwfsstaa	WWF 超級明星 (美國版, 新版)	WWF 超級明星 (美國版, 新版)	Technos Japan
wwfsstau	WWF 超級明星 (美國版)	WWF 超級明星 (美國版)	Technos Japan
wwfsstaj	WWF 超級明星 (日本版)	WWF 超級明星 (日本版)	Technos Japan
vball	U.S. 沙灘排球錦標賽 (set 1)	U.S. 沙灘排球錦標賽 (set 1)	Technos
vball2pj	U.S. 沙灘排球錦標賽 (日本版)	U.S. 沙灘排球錦標賽 (日本版)	Technos
ddragon2	雙截龍 II - 復仇 (世界版)	雙截龍 II - 復仇 (世界版)	Technos
ddragn2u	雙截龍 II - 復仇 (美國版)	雙截龍 II - 復仇 (美國版)	Technos
ctribe	戰鬥部落 (美國版)	戰鬥部落 (美國版)	Technos
ctribeb	戰鬥部落 (盜版)	戰鬥部落 (盜版)	bootleg
blockout	立體俄羅斯方塊 (set 1)	立體俄羅斯方塊 (set 1)	Technos + California Dreams
blckout2	立體俄羅斯方塊 (set 2)	立體俄羅斯方塊 (set 2)	Technos + California Dreams
blckoutj	立體俄羅斯方塊 (日本版)	立體俄羅斯方塊 (日本版)	Technos + California Dreams
agress	飛彈大戰略	飛彈大戰略	Palco
agressb	飛彈大戰略 (英文 盜版)	飛彈大戰略 (英文 盜版)	Palco
ddragon3	雙截龍 3 - 羅塞塔石碑 (美國版)	雙截龍 3 - 羅塞塔石碑 (美國版)	Technos
ddrago3b	雙截龍 3 - 羅塞塔石碑 (盜版)	雙截龍 3 - 羅塞塔石碑 (盜版)	bootleg
wwfwfest	WWF 狂熱摔角 (美國版 set 1)	WWF 狂熱摔角 (美國版 set 1)	Technos Japan
wwfwfsta	WWF 狂熱摔角 (美國版 Tecmo)	WWF 狂熱摔角 (美國版 Tecmo)	Technos Japan (Tecmo license)
wwfwfstb	WWF 狂熱摔角 (美國版 盜版)	WWF 狂熱摔角 (美國版 盜版)	bootleg
wwfwfstj	WWF 狂熱摔角 (日本版)	WWF 狂熱摔角 (日本版)	Technos Japan
shadfrce	變身忍者 (美國版 Version 2)	變身忍者 (美國版 Version 2)	Technos Japan
sia2650	超級入侵者 / Super Invader Attack	超級入侵者 / Super Invader Attack	Zaccaria/Zelco
tinv2650	超級入侵者 / The Invaders	超級入侵者 / The Invaders	Zaccaria/Zelco
nova2001	Nova 2001 (日本版)	Nova 2001 (日本版)	UPL
nov2001u	Nova 2001 (美國版)	Nova 2001 (美國版)	UPL (Universal license)
ninjakun	忍者君 - 魔城之冒險	忍者君 - 魔城之冒險	[UPL] (Taito license)
xxmissio	XX 任務	XX 任務	UPL
ninjakd2	忍者君 II 阿修羅之章 (set 1)	忍者君 II 阿修羅之章 (set 1)	UPL
ninjak2a	忍者君 II 阿修羅之章 (set 2)	忍者君 II 阿修羅之章 (set 2)	UPL
ninjak2b	忍者君 II 阿修羅之章 (set 3)	忍者君 II 阿修羅之章 (set 3)	UPL
rdaction	忍者君 II 阿修羅之章 / Rad Action	忍者君 II 阿修羅之章 / Rad Action	UPL (World Games license)
robokid	原子機械童	原子機械童	UPL
robokidj	原子機械童 (日本版, Set 1)	原子機械童 (日本版, Set 1)	UPL
robokdj2	原子機械童 (日本版, Set 2)	原子機械童 (日本版, Set 2)	UPL
omegaf	Omega 戰機	Omega 戰機	UPL
omegafs	Omega 戰機 特別版	Omega 戰機 特別版	UPL
bioship	宇宙戰艦 / Bio-ship Paladin	宇宙戰艦 / Bio-ship Paladin	UPL (American Sammy license)
strahl	鋼鐵要塞 (日本版 set 1)	鋼鐵要塞 (日本版 set 1)	UPL
strahla	鋼鐵要塞 (日本版 set 2)	鋼鐵要塞 (日本版 set 2)	UPL
bjtwin	炸彈傑克兄弟	炸彈傑克兄弟	NMK
tdragon2	雷龍 2	雷龍 2	NMK
bigbang	雷龍  2 / Big Bang	雷龍  2 / Big Bang	NMK
tdragon	雷龍	雷龍	NMK (Tecmo license)
tdragonb	雷龍 (盜版)	雷龍 (盜版)	NMK / Tecmo
macross	超時空要塞 MACROSS	超時空要塞 MACROSS	Banpresto
riot	雷軋斗	雷軋斗	NMK
macross2	超時空要塞 MACROSS II	超時空要塞 MACROSS II	Banpresto
nouryoku	腦力向上委員會	腦力向上委員會	Tecmo
ssmissin	S.S. 特命	S.S. 特命	Comad
airattck	空襲 - Air Attack	空襲 - Air Attack	Comad
daireika	麻雀大靈界	麻雀大靈界	Jaleco / NMK
kakumei	麻雀革命	麻雀革命	Jaleco
kakumei2	麻雀革命 II	麻雀革命 II	Jaleco
macrossp	超時空要塞 MACROSS PLUS	超時空要塞 MACROSS PLUS	Banpresto
quizmoon	美少女戰士問答	美少女戰士問答	Banpresto
narc	毒品搜查官 (rev 7.00)	毒品搜查官 (rev 7.00)	Williams
narc3	毒品搜查官 (rev 3.20)	毒品搜查官 (rev 3.20)	Williams
mk	真人快打 / 魔宮帝國 (rev 5.0 T-Unit 03/19/93)	真人快打 / 魔宮帝國 (rev 5.0 T-Unit 03/19/93)	Midway
mkr4	真人快打 / 魔宮帝國 (rev 4.0 T-Unit 02/11/93)	真人快打 / 魔宮帝國 (rev 4.0 T-Unit 02/11/93)	Midway
mkprot9	真人快打 / 魔宮帝國 (開發版, rev 9.0 07/28/92)	真人快打 / 魔宮帝國 (開發版, rev 9.0 07/28/92)	Midway
mkla1	真人快打 / 魔宮帝國 (rev 1.0 08/09/92)	真人快打 / 魔宮帝國 (rev 1.0 08/09/92)	Midway
mkla2	真人快打 / 魔宮帝國 (rev 2.0 08/18/92)	真人快打 / 魔宮帝國 (rev 2.0 08/18/92)	Midway
mkla3	真人快打 / 魔宮帝國 (rev 3.0 08/31/92)	真人快打 / 魔宮帝國 (rev 3.0 08/31/92)	Midway
mkla4	真人快打 / 魔宮帝國 (rev 4.0 09/28/92)	真人快打 / 魔宮帝國 (rev 4.0 09/28/92)	Midway
mkyawdim	真人快打 / 魔宮帝國 (Yawdim 盜版)	真人快打 / 魔宮帝國 (Yawdim 盜版)	Midway
term2	魔鬼終結者 2 - 世界末日 (rev LA3 03/27/92)	魔鬼終結者 2 - 世界末日 (rev LA3 03/27/92)	Midway
term2la2	魔鬼終結者 2 - 世界末日 (rev LA2 12/09/91)	魔鬼終結者 2 - 世界末日 (rev LA2 12/09/91)	Midway
term2la1	魔鬼終結者 2 - 世界末日 (rev LA1 11/01/91)	魔鬼終結者 2 - 世界末日 (rev LA1 11/01/91)	Midway
totcarn	大屠殺 (rev LA1 03/10/92)	大屠殺 (rev LA1 03/10/92)	Midway
totcarnp	大屠殺 (開發版, rev 1.0 01/25/92)	大屠殺 (開發版, rev 1.0 01/25/92)	Midway
mk2	真人快打 II / 魔宮帝國 II (rev L3.1)	真人快打 II / 魔宮帝國 II (rev L3.1)	Midway
mk2r32	真人快打 II / 魔宮帝國 II (rev L3.2 (European))	真人快打 II / 魔宮帝國 II (rev L3.2 (European))	Midway
mk2r21	真人快打 II / 魔宮帝國 II (rev L2.1)	真人快打 II / 魔宮帝國 II (rev L2.1)	Midway
mk2r14	真人快打 II / 魔宮帝國 II (rev L1.4)	真人快打 II / 魔宮帝國 II (rev L1.4)	Midway
mk2r42	真人快打 II / 魔宮帝國 II (rev L4.2, hack)	真人快打 II / 魔宮帝國 II (rev L4.2, hack)	hack
mk2r91	真人快打 II / 魔宮帝國 II (rev L9.1, hack)	真人快打 II / 魔宮帝國 II (rev L9.1, hack)	hack
mk2chal	真人快打 II / 魔宮帝國 II 挑戰者 (hack)	真人快打 II / 魔宮帝國 II 挑戰者 (hack)	hack
jdreddp	超時空戰警 (rev LA1, 開發版)	超時空戰警 (rev LA1, 開發版)	Midway
nbajam	NBA 籃球 (rev 3.01 04/07/93)	NBA 籃球 (rev 3.01 04/07/93)	Midway
nbajamr2	NBA 籃球 (rev 2.00 02/10/93)	NBA 籃球 (rev 2.00 02/10/93)	Midway
nbajamte	NBA 籃球 TE (rev 4.0 03/23/94)	NBA 籃球 TE (rev 4.0 03/23/94)	Midway
nbajamt1	NBA 籃球 TE (rev 1.0 01/17/94)	NBA 籃球 TE (rev 1.0 01/17/94)	Midway
nbajamt2	NBA 籃球 TE (rev 2.0 01/28/94)	NBA 籃球 TE (rev 2.0 01/28/94)	Midway
nbajamt3	NBA 籃球 TE (rev 3.0 03/04/94)	NBA 籃球 TE (rev 3.0 03/04/94)	Midway
revx	X 革命 (Rev. 1.0 6/16/94)	X 革命 (Rev. 1.0 6/16/94)	Midway
mk3	真人快打 3 / 魔宮帝國 3 (rev 2.1)	真人快打 3 / 魔宮帝國 3 (rev 2.1)	Midway
mk3r20	真人快打 3 / 魔宮帝國 3 (rev 2.0)	真人快打 3 / 魔宮帝國 3 (rev 2.0)	Midway
mk3r10	真人快打 3 / 魔宮帝國 3 (rev 1.0)	真人快打 3 / 魔宮帝國 3 (rev 1.0)	Midway
umk3	真人快打 3 / 終極魔宮帝國 3 (rev 1.2)	真人快打 3 / 終極魔宮帝國 3 (rev 1.2)	Midway
umk3r11	真人快打 3 / 終極魔宮帝國 3 (rev 1.1)	真人快打 3 / 終極魔宮帝國 3 (rev 1.1)	Midway
umk3r10	真人快打 3 / 終極魔宮帝國 3 (rev 1.0)	真人快打 3 / 終極魔宮帝國 3 (rev 1.0)	Midway
wwfmania	WWF: 瘋狂摔角 (rev 1.30 08/10/95)	WWF: 瘋狂摔角 (rev 1.30 08/10/95)	Midway
wwfmanib	WWF: 瘋狂摔角 (rev 1.20 08/02/95)	WWF: 瘋狂摔角 (rev 1.20 08/02/95)	Midway
nbahangt	NBA 灌籃奇兵 (rev L1.1 04/16/96)	NBA 灌籃奇兵 (rev L1.1 04/16/96)	Midway
nbamht	NBA 極限灌籃奇兵 (rev 1.03 06/09/97)	NBA 極限灌籃奇兵 (rev 1.03 06/09/97)	Midway
nbamht1	NBA 極限灌籃奇兵 (rev 1.0 11/08/96)	NBA 極限灌籃奇兵 (rev 1.0 11/08/96)	Midway
wargods	戰神	戰神	Midway
mk4	真人快打 4 / 魔宮帝國 4 (rev L3)	真人快打 4 / 魔宮帝國 4 (rev L3)	Midway
calspeed	加州飆車 (Version 2.1a, 4/17/98)	加州飆車 (Version 2.1a, 4/17/98)	Atari Games
calspeda	加州飆車 (Version 1.0r7a 3/4/98)	加州飆車 (Version 1.0r7a 3/4/98)	Atari Games
vaportrx	極速穿越	極速穿越	Atari Games
vaportrp	極速穿越 (開發版)	極速穿越 (開發版)	Atari Games
blitz	NFL 迅雷美式足球 (boot ROM 1.2)	NFL 迅雷美式足球 (boot ROM 1.2)	Midway Games
blitz11	NFL 迅雷美式足球 (boot ROM 1.1)	NFL 迅雷美式足球 (boot ROM 1.1)	Midway Games
blitz99	NFL 迅雷美式足球 '99	NFL 迅雷美式足球 '99	Midway Games
blitz2k	NFL 迅雷美式足球 2000 GOLD EDITION	NFL 迅雷美式足球 2000 GOLD EDITION	Midway Games
gauntleg	聖鎧傳說 武士列傳 (version 1.6)	聖鎧傳說 武士列傳 (version 1.6)	Atari Games
gauntl12	聖鎧傳說 武士列傳 (version 1.2)	聖鎧傳說 武士列傳 (version 1.2)	Atari Games
nbashowt	NBA 個人秀: NBA on NBC	NBA 個人秀: NBA on NBC	Midway Games
nbanfl	NBA 個人秀 / NFL 迅雷美式足球 2000	NBA 個人秀 / NFL 迅雷美式足球 2000	Midway Games
gauntdl	聖鎧傳說 暗黑遺產 (version DL 2.52)	聖鎧傳說 暗黑遺產 (version DL 2.52)	Midway Games
gauntd24	聖鎧傳說 暗黑遺產 (version DL 2.4)	聖鎧傳說 暗黑遺產 (version DL 2.4)	Midway Games
armora	武裝襲擊	武裝襲擊	Cinematronics
armorap	武裝襲擊 (開發版)	武裝襲擊 (開發版)	Cinematronics
armorar	武裝襲擊 (Rock-ola)	武裝襲擊 (Rock-ola)	Cinematronics (Rock-ola license)
qb3	QB-3 (開發版)	QB-3 (開發版)	Rock-ola
cchasm	宇宙峽谷 (set 1)	宇宙峽谷 (set 1)	Cinematronics / GCE
cchasm1	宇宙峽谷 (set 2)	宇宙峽谷 (set 2)	Cinematronics / GCE
sbagman	超級袋子人	超級袋子人	Valadon Automation
sbagmans	超級袋子人 (Stern)	超級袋子人 (Stern)	Valadon Automation (Stern license)
tankbust	坦克破壞者	坦克破壞者	Valadon Automation
kungfut	功夫大君	功夫大君	Seibu Kaihatsu Inc.
kungfuta	功夫大君 (alt)	功夫大君 (alt)	Seibu Kaihatsu Inc.
kncljoe	北斗神拳 [偽] (set 1)	北斗神拳 [偽] (set 1)	[Seibu Kaihatsu] (Taito license)
kncljoea	北斗神拳 [偽] (set 2)	北斗神拳 [偽] (set 2)	[Seibu Kaihatsu] (Taito license)
bcrusher	北斗神拳 [偽] / Bone Crusher	北斗神拳 [偽] / Bone Crusher	bootleg
empcity	帝都: 1931 (盜版?)	帝都: 1931 (盜版?)	Seibu Kaihatsu
empcityu	帝都: 1931 (美國版)	帝都: 1931 (美國版)	[Seibu Kaihatsu] (Taito / Romstar license)
empcityj	帝都: 1931 (日本版)	帝都: 1931 (日本版)	[Seibu Kaihatsu] (Taito license)
stfight	帝都: 1931 / Street Fight (德國版)	帝都: 1931 / Street Fight (德國版)	Seibu Kaihatsu
stfighta	帝都: 1931 / Street Fight	帝都: 1931 / Street Fight	Seibu Kaihatsu
dynduke	毀滅公爵 (日本版)	毀滅公爵 (日本版)	Seibu Kaihatsu
dyndukf	毀滅公爵 (美國版)	毀滅公爵 (美國版)	Seibu Kaihatsu (Fabtek license)
dbldyn	毀滅公爵 / The Double Dynamites (日本版)	毀滅公爵 / The Double Dynamites (日本版)	Seibu Kaihatsu
dbldynf	毀滅公爵 / The Double Dynamites (美國版)	毀滅公爵 / The Double Dynamites (美國版)	Seibu Kaihatsu (Fabtek license)
raiden	雷電	雷電	Seibu Kaihatsu
raidena	雷電 (Alternate Hardware)	雷電 (Alternate Hardware)	Seibu Kaihatsu
raidenk	雷電 (韓國版)	雷電 (韓國版)	Seibu Kaihatsu (IBL Corporation license)
raident	雷電 (台灣版)	雷電 (台灣版)	Seibu Kaihatsu (Liang HWA Electronics license)
sdgndmps	機動戰士 SD 鋼彈	機動戰士 SD 鋼彈	Banpresto / Bandai
sengokmj	戰國麻雀 (日本版)	戰國麻雀 (日本版)	Sigma
raiden2	雷電 2 (set 1, 美國版 Fabtek)	雷電 2 (set 1, 美國版 Fabtek)	Seibu Kaihatsu
raiden2a	雷電 2 (set 2, Metrotainment)	雷電 2 (set 2, Metrotainment)	Seibu Kaihatsu
raiden2b	雷電 2 (set 3, 日本版)	雷電 2 (set 3, 日本版)	Seibu Kaihatsu
raiden2c	雷電 2 (set 4, 日本版)	雷電 2 (set 4, 日本版)	Seibu Kaihatsu
raiden2e	雷電 2 (easier?)	雷電 2 (easier?)	Seibu Kaihatsu
raidndx	雷電 DX (set 1)	雷電 DX (set 1)	Seibu Kaihatsu
raidndxa	雷電 DX (set 2)	雷電 DX (set 2)	Seibu Kaihatsu
raidndxb	雷電 DX (set 3, 新 V33 PCB)	雷電 DX (set 3, 新 V33 PCB)	Seibu Kaihatsu
raidndxj	雷電 DX (日本版)	雷電 DX (日本版)	Seibu Kaihatsu
raidndxm	雷電 DX (Metrotainment license)	雷電 DX (Metrotainment license)	Seibu Kaihatsu
senkyu	戰球 (日本版)	戰球 (日本版)	Seibu Kaihatsu
senkyua	戰球 (日本版, set 2)	戰球 (日本版, set 2)	Seibu Kaihatsu
batlball	戰球 / Battle Balls (德國版)	戰球 / Battle Balls (德國版)	Seibu Kaihatsu (Tuning License)
batlbala	戰球 / Battle Balls (亞洲版)	戰球 / Battle Balls (亞洲版)	Seibu Kaihatsu (Metrotainment License)
ejanhs	E 雀高校 (日本版)	E 雀高校 (日本版)	Seibu Kaihatsu
rdft	雷電戰機 (日本版 set 1)	雷電戰機 (日本版 set 1)	Seibu Kaihatsu
rdftu	雷電戰機 (美國版)	雷電戰機 (美國版)	Seibu Kaihatsu (Fabtek license)
rdftau	雷電戰機 (澳洲版)	雷電戰機 (澳洲版)	Seibu Kaihatsu
rdftj	雷電戰機 (日本版 set 2)	雷電戰機 (日本版 set 2)	Seibu Kaihatsu
rdftdi	雷電戰機 (Dream Island Co. license)	雷電戰機 (Dream Island Co. license)	Seibu Kaihatsu (Dream Island license)
rdft2	雷電戰機 2	雷電戰機 2	Seibu Kaihatsu (Tuning license)
rdft2a	雷電戰機 2 (亞洲版, Metrotainment license, SPI)	雷電戰機 2 (亞洲版, Metrotainment license, SPI)	Seibu Kaihatsu (Metrotainment license)
rdft2a2	雷電戰機 2 (亞洲版, Dream Island license, SPI)	雷電戰機 2 (亞洲版, Dream Island license, SPI)	Seibu Kaihatsu (Dream Island license)
rdft2j	雷電戰機 2 (日本版, SPI)	雷電戰機 2 (日本版, SPI)	Seibu Kaihatsu
rdft2us	雷電戰機 2.1 (美國版, Single Board)	雷電戰機 2.1 (美國版, Single Board)	Seibu Kaihatsu (Fabtek license)
rdft22kc	雷電戰機 2 - 2000 (中國版)	雷電戰機 2 - 2000 (中國版)	Seibu Kaihatsu
rfjet	雷電戰機 JET	雷電戰機 JET	Seibu Kaihatsu (Tuning license)
rfjetu	雷電戰機 JET (美國版)	雷電戰機 JET (美國版)	Seibu Kaihatsu (Fabtek license)
rfjeta	雷電戰機 JET (亞洲版)	雷電戰機 JET (亞洲版)	Seibu Kaihatsu (Dream Island license)
rfjetj	雷電戰機 JET (日本版)	雷電戰機 JET (日本版)	Seibu Kaihatsu
rfjetus	雷電戰機 JET (美國版, Single Board)	雷電戰機 JET (美國版, Single Board)	Seibu Kaihatsu (Fabtek license)
cabal	勇士們 (美國版 set 1)	勇士們 (美國版 set 1)	Tad (Fabtek license)
cabal2	勇士們 (美國版 set 2)	勇士們 (美國版 set 2)	Tad (Fabtek license)
cabalbl	勇士們 (盜版)	勇士們 (盜版)	bootleg
toki	人猿傳說 / Toki (世界版 set 1)	人猿傳說 / Toki (世界版 set 1)	Tad
tokia	人猿傳說 / Toki (世界版 set 2)	人猿傳說 / Toki (世界版 set 2)	Tad
tokij	人猿傳說 (日本版)	人猿傳說 (日本版)	Tad
tokiu	人猿傳說 / Toki (美國版)	人猿傳說 / Toki (美國版)	Tad (Fabtek license)
tokib	人猿傳說 / Toki (盜版)	人猿傳說 / Toki (盜版)	bootleg
skysmash	空中打擊者	空中打擊者	Nihon System
legionna	格鬥貴族 (世界版)	格鬥貴族 (世界版)	Tad
legionnu	格鬥貴族 (美國版)	格鬥貴族 (美國版)	Tad (Fabtek license)
denjinmk	電神魔傀	電神魔傀	Banpresto
exerion	火鳳凰	火鳳凰	Jaleco
exeriont	火鳳凰 (Taito)	火鳳凰 (Taito)	Jaleco (Taito America license)
exerionb	火鳳凰 (盜版)	火鳳凰 (盜版)	Jaleco
momoko	桃子 120%	桃子 120%	Jaleco
psychic5	超能力 5	超能力 5	Jaleco
ginganin	銀河任俠傳 (set 1)	銀河任俠傳 (set 1)	Jaleco
gingania	銀河任俠傳 (set 2)	銀河任俠傳 (set 2)	Jaleco
f1gpstar	F1 明星汽車大獎賽 / Grand Prix Star	F1 明星汽車大獎賽 / Grand Prix Star	Jaleco
f1gpstr2	F1 明星汽車大獎賽 II	F1 明星汽車大獎賽 II	Jaleco
tetrisp2	俄羅斯方塊 PLUS 2 (世界版?)	俄羅斯方塊 PLUS 2 (世界版?)	Jaleco / The Tetris Company
teplus2j	俄羅斯方塊 PLUS 2 (日本版)	俄羅斯方塊 PLUS 2 (日本版)	Jaleco / The Tetris Company
rockn	搖滾音樂機 (日本版)	搖滾音樂機 (日本版)	Jaleco
rockna	搖滾音樂機 (日本版, alternate)	搖滾音樂機 (日本版, alternate)	Jaleco
rockn2	搖滾音樂機 2 (日本版)	搖滾音樂機 2 (日本版)	Jaleco
rocknms	搖滾音樂機 MegaSession (日本版)	搖滾音樂機 MegaSession (日本版)	Jaleco
rockn3	搖滾音樂機 3 (日本版)	搖滾音樂機 3 (日本版)	Jaleco
rockn4	搖滾音樂機 3 (日本版, 開發版)	搖滾音樂機 3 (日本版, 開發版)	Jaleco (PCCWJ)
lomakai	魔魁傳說 / Legend of Makai (世界版)	魔魁傳說 / Legend of Makai (世界版)	Jaleco
makaiden	魔魁傳說 (日本版)	魔魁傳說 (日本版)	Jaleco
p47	P-47 - 自由戰士 / P-47 - The Phantom Fighter (世界版)	P-47 - 自由戰士 / P-47 - The Phantom Fighter (世界版)	Jaleco
p47j	P-47 - 自由戰士 (日本版)	P-47 - 自由戰士 (日本版)	Jaleco
tshingen	武田信玄 (日本版, 日文)	武田信玄 (日本版, 日文)	Jaleco
tshingna	武田信玄 / Shingen Samurai-Fighter (日本版, 英文)	武田信玄 / Shingen Samurai-Fighter (日本版, 英文)	Jaleco
kazan	伊賀忍術傳 - 五神之書 (世界版)	伊賀忍術傳 - 五神之書 (世界版)	Jaleco
iganinju	伊賀忍術傳 - 五神之書 (日本版)	伊賀忍術傳 - 五神之書 (日本版)	Jaleco
hachoo	破兆!	破兆!	Jaleco
jitsupro	實力!! 職業棒球 (日本版)	實力!! 職業棒球 (日本版)	Jaleco
stdragon	天聖龍	天聖龍	Jaleco
rodland	妖精物語 (世界版)	妖精物語 (世界版)	Jaleco
rodlandj	妖精物語 (日本版)	妖精物語 (日本版)	Jaleco
rodlndjb	妖精物語 (日本版 盜版)	妖精物語 (日本版 盜版)	Jaleco
avspirit	復仇精靈 / Avenging Spirit	復仇精靈 / Avenging Spirit	Jaleco
phantasm	復仇精靈 (日本版)	復仇精靈 (日本版)	Jaleco
edf	地球保衛戰	地球保衛戰	Jaleco
edfu	地球保衛戰 (North America)	地球保衛戰 (North America)	Jaleco
64street	64 街 (世界版)	64 街 (世界版)	Jaleco
64streej	64 街 (日本版)	64 街 (日本版)	Jaleco
chimerab	原生獸 (開發版)	原生獸 (開發版)	Jaleco
desertwr	海灣戰爭	海灣戰爭	Jaleco
tetrisp	俄羅斯方塊 PLUS	俄羅斯方塊 PLUS	Jaleco / BPS
kirarast	流星雀士	流星雀士	Jaleco
tp2m32	俄羅斯方塊 PLUS 2 (MegaSystem 32 Version)	俄羅斯方塊 PLUS 2 (MegaSystem 32 Version)	Jaleco
f1superb	F1 超級戰鬥	F1 超級戰鬥	Jaleco
rabiolep	兔戰士 (日本版)	兔戰士 (日本版)	V-System Co.
rpunch	兔戰士 / Rabbit Punch (美國版)	兔戰士 / Rabbit Punch (美國版)	V-System Co. (Bally/Midway/Sente license)
svolley	超級排球 (日本版)	超級排球 (日本版)	V-System Co.
svolleyk	超級排球 (韓國版)	超級排球 (韓國版)	V-System Co.
svolleyu	超級排球 (美國版)	超級排球 (美國版)	V-System Co. (Data East license)
tail2nos	超級方程式 / Tail to Nose - Great Championship	超級方程式 / Tail to Nose - Great Championship	V-System Co.
sformula	超級方程式 (日本版)	超級方程式 (日本版)	V-System Co.
ojankoc	雀子俱樂部 (日本版)	雀子俱樂部 (日本版)	V-System Co.
ojankoy	雀子館 (日本版)	雀子館 (日本版)	V-System Co.
ojanko2	雀子館 2 番館 (日本版)	雀子館 2 番館 (日本版)	V-System Co.
ojankohs	雀子高校 (日本版)	雀子高校 (日本版)	V-System Co.
nekkyoku	列島縱斷 熱局雀士 - 東日本編 (日本版)	列島縱斷 熱局雀士 - 東日本編 (日本版)	Video System Co.
idolmj	偶像麻雀放送局 (日本版)	偶像麻雀放送局 (日本版)	System Service
mjnatsu	麻雀夏物語 (日本版)	麻雀夏物語 (日本版)	Video System Co.
natsuiro	麻雀夏物語 / 夏色麻雀 (日本版)	麻雀夏物語 / 夏色麻雀 (日本版)	Video System Co.
mfunclub	麻雀俱樂部 - 偶像最前線 (日本版)	麻雀俱樂部 - 偶像最前線 (日本版)	Video System Co.
daiyogen	麻雀大預言 (日本版)	麻雀大預言 (日本版)	Video System Co.
nmsengen	熱血麻雀宣言! AFTER 5 (日本版)	熱血麻雀宣言! AFTER 5 (日本版)	Video System Co.
fromance	偶像麻雀 最終羅曼史 (日本版)	偶像麻雀 最終羅曼史 (日本版)	Video System Co.
pspikes	超級排球 '91 / Power Spikes (世界版)	超級排球 '91 / Power Spikes (世界版)	Video System Co.
pspikesk	超級排球 '91 / Power Spikes (韓國版)	超級排球 '91 / Power Spikes (韓國版)	Video System Co.
svolly91	超級排球 '91 (日本版)	超級排球 '91 (日本版)	Video System Co.
pspikesb	超級排球 '91 / Power Spikes (盜版)	超級排球 '91 / Power Spikes (盜版)	bootleg
karatblz	鬥神光輝 (世界版?)	鬥神光輝 (世界版?)	Video System Co.
karatblu	鬥神光輝 (美國版)	鬥神光輝 (美國版)	Video System Co.
karatblj	鬥神光輝 (日本版)	鬥神光輝 (日本版)	Video System Co.
turbofrc	超級空軍	超級空軍	Video System Co.
aerofgt	音速戰機 / Aero Fighters	音速戰機 / Aero Fighters	Video System Co.
aerofgtb	音速戰機 / Aero Fighters (Turbo Force hardware set 1)	音速戰機 / Aero Fighters (Turbo Force hardware set 1)	Video System Co.
aerofgtc	音速戰機 / Aero Fighters (Turbo Force hardware set 2)	音速戰機 / Aero Fighters (Turbo Force hardware set 2)	Video System Co.
sonicwi	音速戰機 (日本版)	音速戰機 (日本版)	Video System Co.
aerfboot	音速戰機 / Aero Fighters (盜版)	音速戰機 / Aero Fighters (盜版)	bootleg
twrldc94	Tecmo 世界盃足球 '94	Tecmo 世界盃足球 '94	Tecmo
twrdc94a	Tecmo 世界盃足球 '94 (set 2)	Tecmo 世界盃足球 '94 (set 2)	Tecmo
suprslam	灌籃高手	灌籃高手	Banpresto / Toei Animation
fromanc2	對戰偶像麻雀 最終羅曼史 2 (日本版)	對戰偶像麻雀 最終羅曼史 2 (日本版)	Video System Co.
fromancr	對戰麻雀 最終羅曼史 R (日本版)	對戰麻雀 最終羅曼史 R (日本版)	Video System Co.
fromanc4	對戰麻雀 最終羅曼史 4 (日本版)	對戰麻雀 最終羅曼史 4 (日本版)	Video System Co.
samuraia	戰國 ACE / Samurai Aces (世界版)	戰國 ACE / Samurai Aces (世界版)	Psikyo
sngkace	戰國 ACE (日本版)	戰國 ACE (日本版)	Psikyo
gunbird	武裝飛鳥 (世界版)	武裝飛鳥 (世界版)	Psikyo
gunbirdk	武裝飛鳥 (韓國版)	武裝飛鳥 (韓國版)	Psikyo
gunbirdj	武裝飛鳥 (日本版)	武裝飛鳥 (日本版)	Psikyo
s1945	打擊者 1945	打擊者 1945	Psikyo
s1945a	打擊者 1945 (Alt)	打擊者 1945 (Alt)	Psikyo
s1945j	打擊者 1945 (日本版)	打擊者 1945 (日本版)	Psikyo
s1945jn	打擊者 1945 (日本版, unprotected)	打擊者 1945 (日本版, unprotected)	Psikyo
tengai	戰國之刃: 戰國 ACE 章節 II	戰國之刃: 戰國 ACE 章節 II	Psikyo
s1945ii	打擊者 1945 II	打擊者 1945 II	Psikyo
soldivid	太陽表決	太陽表決	Psikyo
sbomberb	太空轟炸機 (ver. B)	太空轟炸機 (ver. B)	Psikyo
daraku	墮落天使	墮落天使	Psikyo
gunbird2	武裝飛鳥 2	武裝飛鳥 2	Psikyo
s1945iii	打擊者 1945 III (世界版) / 打擊者 1999 (日本版)	打擊者 1945 III (世界版) / 打擊者 1999 (日本版)	Psikyo
dragnblz	火龍傳說	火龍傳說	Psikyo
mjgtaste	G-Taste 麻雀	G-Taste 麻雀	Psikyo
hotgmck	對戰麻雀熱情花招 (日本版)	對戰麻雀熱情花招 (日本版)	Psikyo
hgkairak	對戰麻雀熱情花招 快樂天 (日本版)	對戰麻雀熱情花招 快樂天 (日本版)	Psikyo
hotgmck3	對戰麻雀熱情花招 3 數位衝浪 (日本版)	對戰麻雀熱情花招 3 數位衝浪 (日本版)	Psikyo
hotgm4ev	對戰麻雀熱情花招 4 Ever (日本版)	對戰麻雀熱情花招 4 Ever (日本版)	Psikyo
hotgmcki	對戰麻雀熱情花招 Integral (日本版)	對戰麻雀熱情花招 Integral (日本版)	Psikyo
biomtoy	生化玩具兵 (unprotected)	生化玩具兵 (unprotected)	Gaelco
djboy	DJ 男孩	DJ 男孩	Sammy / Williams [Kaneko]
djboyj	DJ 男孩 (日本版)	DJ 男孩 (日本版)	Sega [Kaneko]
airbustr	空中堡壘 (世界版)	空中堡壘 (世界版)	Kaneko (Namco license)
airbustj	空中堡壘 (日本版)	空中堡壘 (日本版)	Kaneko (Namco license)
galpanic	天蠶變 (set 1)	天蠶變 (set 1)	Kaneko
galpanib	天蠶變 (set 2)	天蠶變 (set 2)	Kaneko
galpania	天蠶變 (set 3)	天蠶變 (set 3)	Kaneko
galpani2	天蠶變 II (日本版?)	天蠶變 II (日本版?)	Kaneko
gpan2qiz	天蠶變 II - 問答版 (日本版)	天蠶變 II - 問答版 (日本版)	Kaneko
galpani3	天蠶變 3	天蠶變 3	Kaneko
berlwall	柏林圍牆	柏林圍牆	Kaneko
berlwalt	柏林圍牆 (盜版 ?)	柏林圍牆 (盜版 ?)	Kaneko
mgcrystl	魔法水晶 (世界版, 92/01/10)	魔法水晶 (世界版, 92/01/10)	Kaneko
mgcrysto	魔法水晶 (世界版, 91/12/10)	魔法水晶 (世界版, 91/12/10)	Kaneko
mgcrystj	魔法水晶 (日本版, 92/01/13)	魔法水晶 (日本版, 92/01/13)	Kaneko (Atlus license)
blazeon	魂之光輝 (日本版)	魂之光輝 (日本版)	Atlus
explbrkr	爆裂戰機 / Explosive Breaker	爆裂戰機 / Explosive Breaker	Kaneko
bakubrkr	爆裂戰機	爆裂戰機	Kaneko
bonkadv	究極!! PC 原人	究極!! PC 原人	Kaneko
galpani4	天蠶變 4 遊 (日本版)	天蠶變 4 遊 (日本版)	Kaneko
galpanis	天蠶變 S - EXTRA EDITION - (日本版)	天蠶變 S - EXTRA EDITION - (日本版)	Kaneko
sengekis	閃激戰機 (亞洲版)	閃激戰機 (亞洲版)	Kaneko / Warashi
sengekij	閃激戰機 (日本版)	閃激戰機 (日本版)	Kaneko / Warashi
galpans2	天蠶變 S2 (日本版)	天蠶變 S2 (日本版)	Kaneko
senknow	線腦 (日本版)	線腦 (日本版)	Kaneko / Kouyousha
puzzloop	渦輪泡泡 (歐洲版)	渦輪泡泡 (歐洲版)	Mitchell
puzloopj	渦輪泡泡 (日本版)	渦輪泡泡 (日本版)	Mitchell
puzloopk	渦輪泡泡 (韓國版)	渦輪泡泡 (韓國版)	Mitchell
puzloopu	渦輪泡泡 (美國版)	渦輪泡泡 (美國版)	Mitchell
ryouran	VS 麻雀 - 乙女繚亂	VS 麻雀 - 乙女繚亂	Electro Design
teljan	TEL 雀	TEL 雀	Electro Design
hanaawas	花札 (Flower Matching)	花札 (Flower Matching)	Seta
srmp2	超真實麻雀 Part 2 (日本版)	超真實麻雀 Part 2 (日本版)	Seta
srmp3	超真實麻雀 Part 3 (日本版)	超真實麻雀 Part 3 (日本版)	Seta
mjyuugi	麻雀遊技 (日本版 set 1)	麻雀遊技 (日本版 set 1)	Visco
mjyuugia	麻雀遊技 (日本版 set 2)	麻雀遊技 (日本版 set 2)	Visco
tndrcade	特殊部隊 U.A.G. / Thundercade / Twin Formation	特殊部隊 U.A.G. / Thundercade / Twin Formation	[Seta] (Taito license)
tndrcadj	特殊部隊 U.A.G. (日本版)	特殊部隊 U.A.G. (日本版)	[Seta] (Taito license)
twineagl	雙鷹	雙鷹	Seta (Taito license)
downtown	目擊 (Set 1)	目擊 (Set 1)	Seta
downtow2	目擊 (Set 2)	目擊 (Set 2)	Seta
downtowp	目擊 (開發版)	目擊 (開發版)	Seta
calibr50	口徑 50	口徑 50	Athena / Seta
metafox	沙漠之狐	沙漠之狐	Seta
neobattl	SD 鋼彈大戰 (日本版)	SD 鋼彈大戰 (日本版)	Banpresto / Sotsu Agency. Sunrise
umanclub	鹹蛋超人俱樂部	鹹蛋超人俱樂部	Tsuburaya Prod. / Banpresto
zingzip	真真急炮	真真急炮	Allumer + Tecmo
kamenrid	假面騎士俱樂部	假面騎士俱樂部	Toei / Banpresto
msgundam	機動戰士	機動戰士	Banpresto
msgunda1	機動戰士 (日本版)	機動戰士 (日本版)	Banpresto
daioh	大王	大王	Athena
utoukond	鹹蛋超人 鬥魂傳說 (日本版)	鹹蛋超人 鬥魂傳說 (日本版)	Banpresto + Tsuburaya Prod.
wrofaero	空戰 - MEIOU 計劃	空戰 - MEIOU 計劃	Yang Cheng
kiwame	職業麻雀 極	職業麻雀 極	Athena
extdwnhl	極限滑降 (v1.5)	極限滑降 (v1.5)	Sammy Industries Japan
gundhara	銃彈嵐	銃彈嵐	Banpresto
gundamex	機動戰士 EX Revue	機動戰士 EX Revue	Banpresto
grdians	電神魔傀 II / 電精	電神魔傀 II / 電精	Banpresto
mj4simai	若草物語 - 麻雀四姊妹 (日本版)	若草物語 - 麻雀四姊妹 (日本版)	Maboroshi Ware
myangel	育嬰問答 親親小寶貝 (日本版)	育嬰問答 親親小寶貝 (日本版)	Namco
myangel2	育嬰問答 親親小寶貝 2 (日本版)	育嬰問答 親親小寶貝 2 (日本版)	Namco
penbros	企鵝兄弟 (日本版)	企鵝兄弟 (日本版)	Subsino
srmp4	超真實麻雀 PIV (日本版)	超真實麻雀 PIV (日本版)	Seta
srmp4o	超真實麻雀 PIV (日本版, 舊 set)	超真實麻雀 PIV (日本版, 舊 set)	Seta
srmp7	超真實麻雀 P7 (日本版)	超真實麻雀 P7 (日本版)	Seta
jsk	清水市代女流四冠王監修 女流將棋教室 (日本版)	清水市代女流四冠王監修 女流將棋教室 (日本版)	Visco
vasara	婆裟羅	婆裟羅	Visco
vasara2	婆裟羅 2 (set 1)	婆裟羅 2 (set 1)	Visco
vasara2a	婆裟羅 2 (set 2)	婆裟羅 2 (set 2)	Visco
gdfs	機動戰士 最終射擊 (日本版)	機動戰士 最終射擊 (日本版)	Banpresto
renju	五子棋 - 連珠貴族	五子棋 - 連珠貴族	Visco
srmp5	超真實麻雀 P5	超真實麻雀 P5	Seta
mayjinsn	早指將棋 五月陣戰	早指將棋 五月陣戰	Seta
mayjisn2	早指將棋 五月陣戰 2	早指將棋 五月陣戰 2	Seta
srmp6	超真實麻雀 P6 (日本版)	超真實麻雀 P6 (日本版)	Seta
powerins	豪血寺一族 (日本版)	豪血寺一族 (日本版)	Atlus
powerina	豪血寺一族 / Power Instinct (美國版, 盜版 set 1)	豪血寺一族 / Power Instinct (美國版, 盜版 set 1)	Atlus
powerinb	豪血寺一族 / Power Instinct (美國版, 盜版 set 2)	豪血寺一族 / Power Instinct (美國版, 盜版 set 2)	Atlus
powernjb	豪血寺一族 (日本版, 盜版)	豪血寺一族 (日本版, 盜版)	Atlus
route16	道路追擊 16	道路追擊 16	Tehkan/Sun (Centuri license)
route16a	道路追擊 16 (set 2)	道路追擊 16 (set 2)	Tehkan/Sun (Centuri license)
route16b	道路追擊 16 (盜版)	道路追擊 16 (盜版)	bootleg
routex	道路追擊 16 / Route X (盜版)	道路追擊 16 / Route X (盜版)	bootleg
ttmahjng	T.T 麻雀	T.T 麻雀	Taito
kangaroo	袋鼠	袋鼠	Sun Electronics
kangaroa	袋鼠 (Atari)	袋鼠 (Atari)	[Sun Electronics] (Atari license)
kangarob	袋鼠 (盜版)	袋鼠 (盜版)	bootleg
arabian	阿拉伯冒險	阿拉伯冒險	Sun Electronics
arabiana	阿拉伯冒險 (Atari)	阿拉伯冒險 (Atari)	[Sun Electronics] (Atari license)
strnskil	鋸木王 / Strength & Skill	鋸木王 / Strength & Skill	Sun Electronics
guiness	鋸木王 (日本版)	鋸木王 (日本版)	Sun Electronics
shanghai	上海 (日本版)	上海 (日本版)	Sunsoft
shangha2	上海 II (日本版)	上海 II (日本版)	Sunsoft
shangha3	上海 III (日本版)	上海 III (日本版)	Sunsoft
bssoccer	街頭足球	街頭足球	SunA
uballoon	終極氣球	終極氣球	SunA
gundealr	美女槍手 (set 1)	美女槍手 (set 1)	Dooyong
gundeala	美女槍手 (set 2)	美女槍手 (set 2)	Dooyong
gundealt	美女槍手 (Tecmo)	美女槍手 (Tecmo)	Tecmo
lastday	末日危機 (set 1)	末日危機 (set 1)	Dooyong
lastdaya	末日危機 (set 2)	末日危機 (set 2)	Dooyong
gulfstrm	海灣風暴	海灣風暴	Dooyong
gulfstr2	海灣風暴 (Media Shoji)	海灣風暴 (Media Shoji)	Dooyong (Media Shoji license)
pollux	雙子座之星 (set 1)	雙子座之星 (set 1)	Dooyong
polluxa	雙子座之星 (set 2)	雙子座之星 (set 2)	Dooyong
polluxa2	雙子座之星 (set 3)	雙子座之星 (set 3)	Dooyong
flytiger	飛虎	飛虎	Dooyong
bluehawk	藍鵰	藍鵰	Dooyong
bluehawn	藍鵰 (NTC)	藍鵰 (NTC)	[Dooyong] (NTC license)
hotpinbl	熱血彈珠檯	熱血彈珠檯	Comad & New Japan System
galspnbl	少女彈珠檯	少女彈珠檯	Comad
fantasia	天蠶變幻想曲	天蠶變幻想曲	Comad & New Japan System
newfant	新天蠶變幻想曲	新天蠶變幻想曲	Comad & New Japan System
fantsy95	天蠶變幻想 '95	天蠶變幻想 '95	Hi-max Technology Inc.
missw96	天蠶變少女世界 '96 (Nude)	天蠶變少女世界 '96 (Nude)	Comad
missmw96	天蠶變少女世界 '96 / Miss Mister World '96 (Nude)	天蠶變少女世界 '96 / Miss Mister World '96 (Nude)	Comad
fantsia2	天蠶變幻想曲 II (Explicit)	天蠶變幻想曲 II (Explicit)	Comad
fntsia2a	天蠶變幻想曲 II (Less Explicit)	天蠶變幻想曲 II (Less Explicit)	Comad
wbeachvl	世界沙灘排球 (set 1)	世界沙灘排球 (set 1)	Playmark
wbeachv2	世界沙灘排球 (set 2)	世界沙灘排球 (set 2)	Playmark
natodef	北約防線	北約防線	Pacific Novelty
natodefa	北約防線 (alternate mazes)	北約防線 (alternate mazes)	Pacific Novelty
crzrally	瘋狂拉力賽車 (set 1)	瘋狂拉力賽車 (set 1)	Tecfri
crzralla	瘋狂拉力賽車 (set 2)	瘋狂拉力賽車 (set 2)	Tecfri
crzrallg	瘋狂拉力賽車 (Gecas license)	瘋狂拉力賽車 (Gecas license)	Tecfri (Gecas license)
karatour	空手道大賽	空手道大賽	Mitchell
ladykill	燃燒吧 Gonta!! / Lady Killer	燃燒吧 Gonta!! / Lady Killer	Yanyaka (Mitchell license)
moegonta	燃燒吧 Gonta!! (日本版)	燃燒吧 Gonta!! (日本版)	Yanyaka
poitto	魔法方塊	魔法方塊	Metro / Able Corp.
dharma	達摩道場	達摩道場	Metro
lastfort	牌砦	牌砦	Metro
lastfero	牌砦 (Erotic)	牌砦 (Erotic)	Metro
lastforg	牌砦 (德文)	牌砦 (德文)	Metro
toride2g	牌砦 II - 仇討外傳	牌砦 II - 仇討外傳	Metro
torid2gg	牌砦 II - 仇討外傳 (德文)	牌砦 II - 仇討外傳 (德文)	Metro
daitorid	大牌砦	大牌砦	Metro
dokyusei	麻雀同級生	麻雀同級生	Make Software / Elf / Media Trading
dokyusp	麻雀同級生特別版	麻雀同級生特別版	Make Software / Elf / Media Trading
3kokushi	三刻志 (日本版)	三刻志 (日本版)	Mitchell
gakusai	麻雀學園祭 (日本版)	麻雀學園祭 (日本版)	MakeSoft
gakusai2	麻雀學園祭 2 (日本版)	麻雀學園祭 2 (日本版)	MakeSoft
spcforce	太空武力	太空武力	Venture Line
spcforc2	太空武力 (set 2)	太空武力 (set 2)	Elcon (bootleg?)
meteor	太空武力 / Meteoroids	太空武力 / Meteoroids	Venture Line
paradise	天蠶變樂園	天蠶變樂園	Yun Sung
paradlx	天蠶變樂園 DELUXE	天蠶變樂園 DELUXE	Yun Sung
pbancho	逆轉!! 解謎番長 (日本版)	逆轉!! 解謎番長 (日本版)	Fuuki
burglarx	夜盜 X	夜盜 X	Unico
silkroad	絲路傳說	絲路傳說	Unico
grdnstrm	戰神 - 守護風暴 (韓國版)	戰神 - 守護風暴 (韓國版)	Afega
firehawk	火狐傳說	火狐傳說	ESD
mchampdx	六合一 (ver. 0106, 06/01/2000)	六合一 (ver. 0106, 06/01/2000)	ESD
mchampda	六合一 (ver. 1126, 26/11/1999)	六合一 (ver. 1126, 26/11/1999)	ESD
hedpanic	頭槌小子 (ver. 0315, 15/03/2000)	頭槌小子 (ver. 0315, 15/03/2000)	ESD / Fuuki
hnayayoi	華彌生 (日本版)	華彌生 (日本版)	Dyna Electronics
hnfubuki	華吹雪 [BET] (日本版)	華吹雪 [BET] (日本版)	Dynax
tontonb	東東 [BET] (日本版)	東東 [BET] (日本版)	Dynax
hanamai	華之舞 (日本版)	華之舞 (日本版)	Dynax
hnkochou	華胡蝶 [BET] (日本版)	華胡蝶 [BET] (日本版)	Dynax
hnoridur	華折鶴 (日本版)	華折鶴 (日本版)	Dynax
jantouki	雀鬥記 (日本版)	雀鬥記 (日本版)	Dynax
mjifb	麻雀 IF [BET] (日本版)	麻雀 IF [BET] (日本版)	Dynax
7jigen	7 次元之妖精達 (日本版)	7 次元之妖精達 (日本版)	Dynax
quizchq	民國教育委員會 (Ver 1.00) (日本版)	民國教育委員會 (Ver 1.00) (日本版)	Nakanihon
quizchql	民國教育委員會 (Ver 1.23) (台灣版?)	民國教育委員會 (Ver 1.23) (台灣版?)	Nakanihon (Laxan license)
mjmyster	麻雀 世界的神秘	麻雀 世界的神秘	Dynax
quiz365	每日問答 365 (日本版)	每日問答 365 (日本版)	Nakanihon
quiz365t	每日問答 365 (香港版 & 台灣版)	每日問答 365 (香港版 & 台灣版)	Nakanihon + Taito
rongrong	龍龍 (歐洲版)	龍龍 (歐洲版)	Nakanihon
rongrngg	龍龍 (德國版)	龍龍 (德國版)	Nakanihon
mjdchuka	麻雀 大中華圈 (中國版, v. D111)	麻雀 大中華圈 (中國版, v. D111)	Dynax
ddenlovr	黑白棋 Vol. 1 (香港版)	黑白棋 Vol. 1 (香港版)	Dynax
hkagerou	華陽炎 [BET] (日本版)	華陽炎 [BET] (日本版)	Nakanihon + Dynax
realbrk	撞球學園 Real Break (歐洲版)	撞球學園 Real Break (歐洲版)	Nakanihon
realbrkk	撞球學園 Real Break (韓國版)	撞球學園 Real Break (韓國版)	Nakanihon
realbrkj	撞球學園 Real Break (日本版)	撞球學園 Real Break (日本版)	Nakanihon
mjchuuka	麻雀中華兒女 (中國版)	麻雀中華兒女 (中國版)	Dynax
mjreach1	麻雀 立直一發 (日本版)	麻雀 立直一發 (日本版)	Nihon System
pkgnsh	銀玉勝負 (日本版)	銀玉勝負 (日本版)	Nakanihon / Dynax
pkgnshdx	銀玉勝負 DX (日本版)	銀玉勝負 DX (日本版)	Nakanihon / Dynax
mjelctrn	電子基盤 (parts 2 & 4, 日本版)	電子基盤 (parts 2 & 4, 日本版)	Dynax
mjelct3	電子基盤 (parts 2 & 3, 日本版)	電子基盤 (parts 2 & 3, 日本版)	Dynax
mjelct3a	電子基盤 (parts 2 & 3, alt., 日本版)	電子基盤 (parts 2 & 3, alt., 日本版)	Dynax
nyny	拯救紐約	拯救紐約	Sigma Enterprises Inc.
nynyg	拯救紐約 (Gottlieb)	拯救紐約 (Gottlieb)	Sigma Enterprises Inc. (Gottlieb license)
arcadia	拯救紐約 / Waga Seishun no Arcadia	拯救紐約 / Waga Seishun no Arcadia	Sigma Enterprises Inc.
goldstar	金星水果盤	金星水果盤	IGS
goldstbl	金星水果盤 (Blue version)	金星水果盤 (Blue version)	IGS
moonlght	金星水果盤 / Moon Light	金星水果盤 / Moon Light	unknown
iqblock	IQ 魔術方塊	IQ 魔術方塊	IGS
lhb	龍虎榜	龍虎榜	IGS
chindrag	中國龍 (日本版, V021J)	中國龍 (日本版, V021J)	IGS / ALTA
chugokur	中國龍 (日本版, V020J)	中國龍 (日本版, V020J)	IGS / ALTA
chmplst2	龍虎榜 II	龍虎榜 II	IGS
xymg	幸運滿貫 (V651C)	幸運滿貫 (V651C)	IGS
grtwall	萬里長城 (V638C)	萬里長城 (V638C)	IGS
vbowl	世界杯保齡球 (世界版, V101XCM)	世界杯保齡球 (世界版, V101XCM)	Alta / IGS
vbowlj	世界杯保齡球 (日本版, V100JCM)	世界杯保齡球 (日本版, V100JCM)	Alta / IGS
drgnwrld	中國龍 / Dragon World (世界版, V0400)	中國龍 / Dragon World (世界版, V0400)	IGS
drgwrld3	中國龍 / Dragon World (世界版, V0300)	中國龍 / Dragon World (世界版, V0300)	IGS
lordgun	槍王 (美國版)	槍王 (美國版)	IGS
hfh	黃飛鴻	黃飛鴻	IGS
tarzan	泰山	泰山	IGS
orlegend	西遊釋厄傳 (ver. 126)	西遊釋厄傳 (ver. 126)	IGS
orlegnde	西遊釋厄傳 (ver. 112)	西遊釋厄傳 (ver. 112)	IGS
orlegndc	西遊釋厄傳 (ver. 112, 中文機板)	西遊釋厄傳 (ver. 112, 中文機板)	IGS
orld111c	西遊釋厄傳 (ver. 111, 中文機板)	西遊釋厄傳 (ver. 111, 中文機板)	IGS
orld105k	西遊釋厄傳 (ver. 105, 韓文機板)	西遊釋厄傳 (ver. 105, 韓文機板)	IGS
drgw2	中國龍 II / Dragon World II (ver. 110X, Export)	中國龍 II / Dragon World II (ver. 110X, Export)	IGS
drgw2c	中國龍 II  (ver. 100C, 中國版)	中國龍 II  (ver. 100C, 中國版)	IGS
drgw2j	中國龍 II / Chuugokuryuu II (ver. 100J, 日本版)	中國龍 II / Chuugokuryuu II (ver. 100J, 日本版)	IGS
drgw3	中國龍 3 / Dragon World 3	中國龍 3 / Dragon World 3	IGS
drgw3k	中國龍 3 / Dragon World 3 (韓文機板)	中國龍 3 / Dragon World 3 (韓文機板)	IGS
kov	三國戰記 (ver. 117)	三國戰記 (ver. 117)	IGS
kovplus	三國戰記 正宗 PLUS (ver. 119)	三國戰記 正宗 PLUS (ver. 119)	IGS
kovplusa	三國戰記 正宗 PLUS (alt ver. 119)	三國戰記 正宗 PLUS (alt ver. 119)	IGS
kov115	三國戰記 (ver. 115)	三國戰記 (ver. 115)	IGS
kovj	三國戰記 (ver. 100, 日文機板)	三國戰記 (ver. 100, 日文機板)	IGS
kovsh	三國戰記 - 風雲再起 (ver. 322)	三國戰記 - 風雲再起 (ver. 322)	IGS
photoy2k	大家來找碴	大家來找碴	IGS
raf102j	大家來找碴 / Real and Fake (ver. 102, 日本機板)	大家來找碴 / Real and Fake (ver. 102, 日本機板)	IGS
killbld	傲劍狂刀	傲劍狂刀	IGS
killbldt	傲劍狂刀 (中文機板)	傲劍狂刀 (中文機板)	IGS
puzlstar	魔幻星座	魔幻星座	IGS
olds	西遊釋厄傳 Super / Special (韓國版 101)	西遊釋厄傳 Super / Special (韓國版 101)	IGS
olds100	西遊釋厄傳 Super / Special (100)	西遊釋厄傳 Super / Special (100)	IGS
olds100a	西遊釋厄傳 Super / Special (100 alt)	西遊釋厄傳 Super / Special (100 alt)	IGS
kov2	三國戰記 2	三國戰記 2	IGS
kov2106	三國戰記 2 (106)	三國戰記 2 (106)	IGS
kov2p	三國戰記 2 - 飛龍在天	三國戰記 2 - 飛龍在天	IGS
ddp2	蜂暴 - 怒首領蜂 II	蜂暴 - 怒首領蜂 II	IGS
puzzli2	砰砰釣魚島 / Puzzli 2 Super	砰砰釣魚島 / Puzzli 2 Super	IGS
martmast	形意拳	形意拳	IGS
theglad	神劍伏魔錄	神劍伏魔錄	IGS
dmnfrnt	魔域戰線 (V102)	魔域戰線 (V102)	IGS
dmnfrnta	魔域戰線 (V105)	魔域戰線 (V105)	IGS
bankp	銀行大盜	銀行大盜	[Sanritsu] Sega
mjkjidai	麻雀狂時代 (日本版)	麻雀狂時代 (日本版)	Sanritsu
mayumi	危機一髮真由美 (日本版)	危機一髮真由美 (日本版)	[Sanritsu] Victory L.L.C.
kinst	殺手學堂 (v1.5d)	殺手學堂 (v1.5d)	Rare
kinst14	殺手學堂 (v1.4)	殺手學堂 (v1.4)	Rare
kinst13	殺手學堂 (v1.3)	殺手學堂 (v1.3)	Rare
kinstp	殺手學堂 (proto v4.7)	殺手學堂 (proto v4.7)	Rare
kinst2	殺手學堂 2 (v1.4)	殺手學堂 2 (v1.4)	Rare
kinst2k	殺手學堂 2 (v1.4k, upgrade kit)	殺手學堂 2 (v1.4k, upgrade kit)	Rare
kinst213	殺手學堂 2 (v1.3)	殺手學堂 2 (v1.3)	Rare
kinst211	殺手學堂 2 (v1.1)	殺手學堂 2 (v1.1)	Rare
kinst210	殺手學堂 2 (v1.0)	殺手學堂 2 (v1.0)	Rare
rmhaihai	真實麻雀牌牌 (日本版)	真實麻雀牌牌 (日本版)	Alba
rmhaihib	真實麻雀牌牌 [BET] (日本版)	真實麻雀牌牌 [BET] (日本版)	Alba
rmhaijin	真實麻雀牌牌 - 人事異動篇 (日本版)	真實麻雀牌牌 - 人事異動篇 (日本版)	Alba
rmhaisei	真實麻雀牌牌 - 成長篇 (日本版)	真實麻雀牌牌 - 成長篇 (日本版)	Visco
themj	麻雀 (日本版)	麻雀 (日本版)	Visco
hanaroku	花六	花六	Alba
yumefuda	(Medal) 夢札 [BET]	(Medal) 夢札 [BET]	Alba
hourouki	麻雀放浪記 Part 1 - 青春篇 (日本版)	麻雀放浪記 Part 1 - 青春篇 (日本版)	Home Data
mhgaiden	麻雀放浪記 外傳 (日本版)	麻雀放浪記 外傳 (日本版)	Home Data
mjhokite	麻雀放浪記 掟 (日本版)	麻雀放浪記 掟 (日本版)	Home Data
mrokumei	麻雀 鹿鳴館 (日本版)	麻雀 鹿鳴館 (日本版)	Home Data
reikaids	靈界導士 (日本版)	靈界導士 (日本版)	Home Data
mjkojink	個人教授 (Private Teacher) (日本阪)	個人教授 (Private Teacher) (日本阪)	Home Data
mjyougo	麻雀用語之基礎體力 (日本版)	麻雀用語之基礎體力 (日本版)	Home Data
jogakuen	麻雀女學園 - 身體檢查篇 (日本版)	麻雀女學園 - 身體檢查篇 (日本版)	Windom
shangkid	北派少林 飛龍之拳 / Shanghai Kid	北派少林 飛龍之拳 / Shanghai Kid	Taiyo (Data East license)
hiryuken	北派少林 飛龍之拳	北派少林 飛龍之拳	[Nihon Game] (Taito license)
crysking	國王水晶	國王水晶	Brezzasoft
evosocc	前進足球	前進足球	Evoga
spcking2	太空之王-2	太空之王-2	Konami
spaceint	太空侵略者	太空侵略者	Shoei
spaceinj	太空侵略者 (日本版)	太空侵略者 (日本版)	Shoei
spacefb	太空火鳥 (Nintendo)	太空火鳥 (Nintendo)	Nintendo
spacefbg	太空火鳥 (Gremlin)	太空火鳥 (Gremlin)	Gremlin
spacefbb	太空火鳥 (盜版)	太空火鳥 (盜版)	bootleg
spacebrd	太空火鳥 / Space Bird (盜版)	太空火鳥 / Space Bird (盜版)	bootleg
spacedem	太空火鳥 / Space Demon	太空火鳥 / Space Demon	Nintendo (Fortrek license)
fitfight	龍虎拳 / Fit of Fighting	龍虎拳 / Fit of Fighting	bootleg
dblpoint	夜上海 - Double Point	夜上海 - Double Point	Min Corp.
dblpoind	夜上海 - Double Point (Dong Bang Electron, 盜版?)	夜上海 - Double Point (Dong Bang Electron, 盜版?)	Dong Bang Electron
luplup	漩渦泡泡 (version 3.0 / 990128)	漩渦泡泡 (version 3.0 / 990128)	Omega System
luplup29	漩渦泡泡 (version 2.9 / 990108)	漩渦泡泡 (version 2.9 / 990108)	Omega System
puzlbang	漩渦泡泡 / Puzzle Bang Bang (version 2.8 / 990106)	漩渦泡泡 / Puzzle Bang Bang (version 2.8 / 990106)	Omega System
suplup	超級漩渦泡泡 (version 4.0 / 990518)	超級漩渦泡泡 (version 4.0 / 990518)	Omega System
fort2b	瘋狂坦克 2 Blue Arcade (ver 1.01 / pcb ver 3.05)	瘋狂坦克 2 Blue Arcade (ver 1.01 / pcb ver 3.05)	Eolith
fort2ba	瘋狂坦克 2 Blue Arcade (ver 1.00 / pcb ver 3.05)	瘋狂坦克 2 Blue Arcade (ver 1.00 / pcb ver 3.05)	Eolith
xfiles	X 檔案	X 檔案	dgPIX Entertainment Inc.
rabbit	羅媚斗	羅媚斗	Electronic Arts / Aorn
cultname	姓名鑑定命名機	姓名鑑定命名機	I'Max
yuka	遊華	遊華	Yubis / T.System
yujan	遊雀	遊雀	Yubis / T.System
bmcbowl	滾球之星	滾球之星	BMC
rbmk	實戰麻將王 加強版	實戰麻將王 加強版	GMS
lastfght	絕地大反攻	絕地大反攻	Subsino
